AAAAAAAAVL	prime_neg
AAAAAAAVL	prime_neg
AAAAAAQQIQV	cedar_neg
AAAALHMQR	prime_neg
AAAAQQIQV	cedar_neg
AAAKAKNIPK	prime_neg
AAAPAVGPPL	prime_neg
AAAPLRGRAL	prime_neg
AAAPPLSPPL	prime_neg
AAATAATTAA	prime_neg
AAFHGVFQKY	prime_neg
AAGFVTEIK	prime_neg
AAHFTVLLY	cedar_neg
AAIAASRSV	cedar_neg
AAKWKANLR	prime_neg
AALHTPRPGPL	cedar_neg
AALLQVTLLL	cedar_pos
AALMELLWEK	prime_neg
AALNPLVYGVK	prime_neg
AALPMGLSL	prime_neg
AAMHGRKIM	cedar_neg
AAPAHSHAV	cedar_neg
AAPLRGRAL	prime_neg
AAPTAVGPPL	prime_neg
AAQARLQPV	cedar_neg
AAQFSSDVL	cedar_neg
AAQSVIKAL	cedar_neg
AARGAACAR	prime_neg
AARGAACARR	prime_neg
AARGHRWPCL	prime_neg
AARGHRWPC	prime_neg
AARQKLLDREL	prime_neg
AASENARQPAK	prime_neg
AASESPSLK	prime_neg
AASSSVQRHPF	prime_neg
AATLKALAGL	prime_neg
AATPVGSLY	cedar_pos
AAYKFRVIAK	prime_neg
AAYQRLTSEK	cedar_neg
ACNIRELHR	prime_neg
AEAERLDVKAI	cedar_neg
AEETPPFSNY	cedar_neg
AEHSLQVAY	cedar_pos
AEPINIQTW	cedar_neg
AERLDVKAI	cedar_neg
AESGLPDLLL	prime_neg
AEVDQDGVVM	cedar_neg
AEVPENVFL	cedar_neg
AEWRNGSTSSL	cedar_neg
AFIETVNAYFK	prime_neg
AFIRRGILK	prime_neg
AFLFVWEPF	prime_neg
AFLPMCRYYR	prime_neg
AFLSTHLKLFL	cedar_neg
AFPVHSWYNF	cedar_neg
AFQELLCLCR	prime_neg
AFQEYDSFEK	prime_neg
AFQTSEKKFYI	cedar_neg
AFWLFWGLTYI	cedar_neg
AGFHVTRNGK	cedar_neg
AGIICTLWAL	prime_neg
AGQHIAKSLF	cedar_pos
AHWDRYMGTL	prime_neg
AIAKFNFNA	cedar_neg
AIANRIKFK	prime_neg
AICKPLHYV	prime_neg
AIDAALTFV	cedar_pos
AIFCGNTEPR	prime_neg
AILLGAEEK	cedar_neg
AILPFTPEF	cedar_neg
AILPFTPEFL	cedar_neg
AILPFTPEFLV	cedar_neg
AIPAMVVPNV	prime_neg
AISCSYGQV	prime_neg
AISLLSLPL	cedar_neg
AISPGGVQEAL	cedar_neg
AIVEFPVPA	cedar_neg
AIVVILMSMV	cedar_neg
AIYHTLNLFNI	cedar_neg
AKNCGIAIPV	cedar_neg
ALAAGSCLV	cedar_neg
ALADLAGFK	cedar_neg
ALADLAGFKEL	cedar_neg
ALAFTPVEQV	cedar_neg
ALAFTPVEQVV	cedar_neg
ALAFVIRPTA	prime_neg
ALAISPDSMV	prime_neg
ALAKETQFW	cedar_neg
ALALAQKGV	cedar_pos
ALALAQKGVQL	cedar_neg
ALAQERWRCLV	cedar_neg
ALAQKGVQLGL	cedar_neg
ALAQKGVQL	prime_neg
ALAQVTKSSAL	prime_neg
ALATEFAEI	prime_neg
ALAVIELYNA	cedar_neg
ALAVKALYPV	cedar_neg
ALCGEDLYVL	prime_neg
ALCGEDLYV	prime_neg
ALCGQCVRI	prime_neg
ALCRHEYPL	cedar_neg
ALCVQPHYITV	cedar_neg
ALDAPLFGI	prime_neg
ALDEVTAMI	prime_neg
ALDGYNGTV	cedar_neg
ALDPHSGHF	cedar_neg
ALDPHSGHFVA	cedar_pos
ALDPHSGHFV	prime_pos
ALDQEAALAK	cedar_neg
ALDYEWGTV	prime_neg
ALDYGGAPPL	prime_neg
ALESIAWFSV	cedar_neg
ALEVLQSIPY	prime_neg
ALFAGSMQL	cedar_neg
ALFALLEIL	cedar_pos
ALFASRPRF	prime_neg
ALFLIFFFV	prime_neg
ALFLVFGRTRK	cedar_pos
ALFNLIGTFPL	cedar_neg
ALFNRAQKL	prime_neg
ALFTADSAQTK	cedar_neg
ALFTWTNLL	prime_neg
ALFTWTNLLV	prime_neg
ALFTWTNLLVV	prime_neg
ALFTWTNL	prime_neg
ALGCSNNEK	cedar_neg
ALGGVFMML	cedar_neg
ALGSLATAQI	prime_neg
ALGTLLHTNV	prime_neg
ALHGGWTTK	cedar_pos
ALHITKTLIEF	prime_neg
ALHSPRCYR	cedar_neg
ALHSSSSYH	cedar_neg
ALHWEQVAV	cedar_neg
ALIDLSSGL	prime_neg
ALIEAYVDI	cedar_neg
ALIGSSSHV	prime_neg
ALIHCSIGDI	prime_neg
ALIHHNTYL	prime_pos
ALLDGGLPA	prime_neg
ALLETPSLL	cedar_pos
ALLETPSLLL	prime_neg
ALLFLESEL	cedar_pos
ALLGSSCAPPL	cedar_neg
ALLMCLLPL	prime_neg
ALLPTPHCESL	cedar_neg
ALLQEEAHV	cedar_neg
ALLQEEAHVPL	cedar_neg
ALLQVTLLL	cedar_pos
ALLVAAEPYL	prime_neg
ALLYFSEMV	prime_neg
ALMELLWEK	prime_neg
ALMGPQYCV	prime_neg
ALMMSLSAL	prime_neg
ALNLQDFYMHL	prime_neg
ALNLQDFYM	prime_neg
ALNPTSGSL	cedar_neg
ALNSSEEYNL	cedar_neg
ALPDPILQSI	prime_neg
ALPILGEQV	cedar_neg
ALPPGLSHSK	prime_neg
ALPQHLIRV	cedar_pos
ALQHFELENSL	cedar_neg
ALQKGRSFNL	prime_neg
ALQKVKIAV	cedar_neg
ALQNFDNKLV	cedar_neg
ALQNYYNKLV	cedar_neg
ALQQCLQGA	cedar_neg
ALQSAYVKI	cedar_neg
ALQSQSISL	prime_neg
ALQSQSISLV	prime_neg
ALQSRLQAL	prime_pos
ALRMLEVPL	cedar_neg
ALSAMMQWV	prime_neg
ALSDITFSGA	prime_neg
ALSDQVRDV	cedar_neg
ALSFYPAEI	prime_neg
ALSIGTSYRY	cedar_neg
ALSPDGSIRK	prime_neg
ALSPGLTRT	cedar_neg
ALSPVIPHI	prime_pos
ALSRSALVRV	prime_neg
ALSTCTSHII	prime_neg
ALSTCTSHIIV	prime_neg
ALSTCTSHI	prime_neg
ALSTIWYEL	prime_neg
ALSVEFSEM	cedar_neg
ALSYLVSFQR	cedar_pos
ALSYTPAEV	cedar_pos
ALTASTVPL	prime_neg
ALTFPMTAL	prime_neg
ALVGAISSI	prime_neg
ALVGNPIDRL	prime_neg
ALVNKLYSL	cedar_neg
ALVPLQWLV	prime_neg
ALVRGVCMKV	cedar_neg
ALVVPVFEI	cedar_neg
ALWDRVVDL	cedar_pos
ALWSLSRHASL	cedar_neg
ALWWYPNGK	prime_neg
ALYFAWIGFY	prime_neg
ALYGFVPVLL	prime_pos
ALYGFVPVL	prime_neg
ALYGLIQKCKK	prime_neg
ALYSDVTLYI	prime_neg
AMAGSLVFL	cedar_neg
AMAVLYLAL	cedar_neg
AMFDFIDCK	prime_neg
AMFKVQEDIKA	prime_neg
AMFKVQEDI	prime_neg
AMGPLAVDNF	prime_neg
AMGPLAVDNFV	prime_neg
AMGVALWGV	prime_neg
AMHGRKIMGK	cedar_neg
AMHNQLTDMEK	cedar_neg
AMIAKISNEL	prime_neg
AMINHVAGL	prime_neg
AMLDLGLAAF	prime_neg
AMLDLGLAA	prime_neg
AMLSKVVIL	cedar_neg
AMPFSIFYPM	cedar_pos
AMQCLQNENL	cedar_neg
AMQKRRLHLSV	cedar_neg
AMRKVCCCQIL	prime_neg
AMRKVCCCQI	prime_neg
AMRLWVIRV	cedar_neg
AMRLWVIRVQK	cedar_neg
AMVHYLMIL	cedar_neg
AMVLAVRGV	cedar_neg
AMYLNYFRGL	cedar_neg
AMYQRAKLK	cedar_neg
AMYSNADIYLF	cedar_neg
ANLENHALFK	prime_neg
APAAAATAA	prime_neg
APAAAATAAT	prime_neg
APAASPTVVV	cedar_neg
APAESPAPEV	prime_neg
APAKSVKKRI	cedar_neg
APALDAPLF	prime_neg
APAPPAPAF	cedar_neg
APARLERRHSA	cedar_pos
APCLESGTCIL	cedar_neg
APESRERVPSV	cedar_neg
APFPLGDSAL	prime_neg
APGITSVEII	prime_neg
APGITSVEI	prime_neg
APGLMGTEQLF	cedar_neg
APGLPGFSGL	cedar_neg
APGPLPRSL	cedar_neg
APHRGHPSL	prime_neg
APKKKSIKL	cedar_neg
APLKEDGIL	prime_neg
APLLQENLRL	cedar_neg
APLPQQFHLKI	cedar_neg
APLRGRALEV	prime_neg
APNLMCTPHAA	prime_neg
APNLQNQMSSL	cedar_neg
APPAAAAPA	prime_neg
APPAAAAPAV	prime_neg
APPILSRGL	prime_neg
APPSAEYESL	cedar_neg
APPSAEYESLV	cedar_neg
APPTQPLPL	prime_neg
APQRQFTEVHL	prime_neg
APQRQFTEV	prime_neg
APQVTESIEF	cedar_neg
APRAGPGVVE	prime_neg
APRAGPGVV	prime_neg
APSLKGKQKQM	cedar_neg
APSPGQPPAL	prime_neg
APTAVGPPL	prime_neg
APTPLPAPQQY	cedar_neg
APTRSNLWEAA	prime_neg
APTRTVKII	cedar_neg
APTRTVKIINV	cedar_neg
APTWRALAR	cedar_neg
APVCRNEMSV	prime_neg
APVFLDCLEL	cedar_neg
APVTRRKFPH	prime_neg
AQAAWLENFPL	cedar_neg
AQALADLAGFK	cedar_neg
AQAPNNYRCF	cedar_neg
AQAPNNYRCFL	cedar_neg
AQAPSLWGA	cedar_neg
AQDIYRASY	cedar_pos
AQDIYRASYY	cedar_pos
AQFCDVRLQV	cedar_neg
AQFIGPLVFV	prime_neg
AQFKGAWIL	prime_neg
AQFSSDVLNLV	cedar_pos
AQGPRFALTL	prime_neg
AQGTGVLGSK	cedar_neg
AQHPTGAGPH	prime_neg
AQILHFQNPGY	cedar_neg
AQKATSLYR	prime_neg
AQLKNLYLKK	prime_neg
AQLKNLYLK	prime_neg
AQLVALLVF	prime_neg
AQPAVQSAF	cedar_neg
AQSWAFEQV	cedar_neg
AQVELNLML	cedar_neg
AQVLQLVAK	prime_neg
AQVTKSSAL	prime_neg
AQWRHDFVL	prime_neg
AQYTLMSQAV	cedar_neg
AQYTLMVQAV	cedar_neg
ARFAVNLRL	cedar_neg
ARHSPPGCHL	prime_neg
ARLFLGLAI	cedar_neg
ARLPVGAYEV	cedar_neg
ARLQFSCYSSL	cedar_pos
ARMWMTLTF	cedar_neg
ARRASKARL	cedar_neg
ARRMGWLSLL	prime_neg
ARVSFTRGL	cedar_neg
ARWKHKTRK	cedar_neg
ARWTAFFGV	cedar_neg
ARYVPLTPWF	cedar_neg
ASADGTVKLW	cedar_neg
ASAELNAALEK	prime_neg
ASAWRNIAAR	cedar_neg
ASCYSSSCY	cedar_neg
ASFCGAVFCKY	cedar_neg
ASFQPFGSQY	prime_neg
ASGAFGTVY	prime_neg
ASHGSVFYFR	prime_neg
ASHPILEDK	prime_neg
ASISSFLLV	cedar_neg
ASISSFLLVR	cedar_neg
ASKGCLRGLAM	prime_neg
ASLAPECGFGR	cedar_neg
ASLDGASLEK	prime_neg
ASLPSKNTPK	prime_neg
ASMPSSPPL	prime_pos
ASMSGRWKR	cedar_neg
ASMSGRWKRK	cedar_neg
ASMTGIVYSL	cedar_neg
ASMTGIVYSLF	cedar_neg
ASNASSAAK	prime_pos
ASNFDDYEEK	prime_neg
ASNSCFIRY	prime_neg
ASSVPTGHATF	cedar_neg
ASSYIILAM	cedar_neg
ASTGDATPL	prime_neg
ASTGHTTPL	prime_neg
ASTGQHTPL	prime_neg
ASVPSAATF	prime_neg
ASVTHSVDK	cedar_neg
ASWVVPIDIK	prime_neg
ASWYRIYSK	cedar_neg
ASWYRIYSKI	cedar_neg
ASYSLSEDK	prime_neg
ATAATQRPK	prime_neg
ATAERSRHHR	cedar_neg
ATALLEYLEY	prime_neg
ATALPFCGPR	prime_neg
ATFLCPANV	cedar_neg
ATFRNNQMK	cedar_neg
ATIVPELNEI	prime_neg
ATKNNKVIMA	cedar_neg
ATKPAQNALEK	cedar_neg
ATKVTADGK	prime_neg
ATLDWSKNAV	cedar_neg
ATLKALAGL	prime_neg
ATLNSFIHVR	cedar_neg
ATLSASAAWV	prime_neg
ATNAKDSSSR	prime_neg
ATPAYPGVVY	prime_neg
ATPGRFLDIIK	cedar_neg
ATPKYSNSLK	cedar_neg
ATPSLHTSV	prime_neg
ATPYRIRFPR	prime_neg
ATQHSMDLLH	prime_neg
ATSELILFPV	prime_neg
ATSSPMTVK	prime_neg
ATTLKAFFK	cedar_pos
ATVPLPTAPK	prime_neg
ATVQKLSRFSL	cedar_neg
AVADMQVGAV	cedar_neg
AVAGEGRAL	prime_neg
AVAGIIPPSV	cedar_neg
AVARSNEMIQR	prime_neg
AVATFYLYMK	prime_neg
AVATFYLYM	prime_neg
AVDDIFVKA	cedar_neg
AVDFSHLYV	prime_neg
AVDKQLASELK	prime_neg
AVDNFVRFV	prime_neg
AVEAMSVRSK	prime_neg
AVFDVGRITEV	cedar_neg
AVFSFTATL	prime_neg
AVFYTILTPV	cedar_neg
AVFYTILTPVL	cedar_neg
AVGSYVYSVAK	cedar_neg
AVGSYVYSV	prime_pos
AVHPSSPPV	prime_neg
AVIDAYTEI	cedar_neg
AVILCRIRK	prime_neg
AVIYVNSCLF	prime_neg
AVIYVNSCL	prime_neg
AVKEAVDILK	prime_neg
AVLLALVLLLL	prime_neg
AVLLALVLLL	prime_neg
AVLLALVLL	prime_neg
AVLLQIMER	prime_neg
AVLQFPVGR	prime_neg
AVLSPQEKREL	cedar_neg
AVLVIKAHK	prime_neg
AVMGAGSSGTA	cedar_neg
AVMGRSYAPY	prime_neg
AVMKFKNPL	cedar_neg
AVMKFKNPLV	cedar_neg
AVMRWGMPL	cedar_pos
AVNAAGTVF	prime_neg
AVNQKPTNLHK	prime_neg
AVPPTATPAY	prime_neg
AVRWFFAHF	cedar_neg
AVRYDPESDTL	cedar_neg
AVSKPGLDYEL	prime_neg
AVSKSASRTHR	prime_neg
AVSLGRLKL	cedar_neg
AVSSCILAK	cedar_neg
AVSSCILAKV	cedar_neg
AVTKEEFQR	prime_neg
AVVMSWAPPV	prime_neg
AVWEYQKPV	prime_neg
AVYHEIHIGYL	cedar_pos
AWIGFYTGWLL	prime_neg
AYFLPRPPL	cedar_neg
AYGKSYQVPML	prime_neg
AYLAFLFVW	prime_neg
AYLEAIHDF	cedar_pos
AYLEAIHHF	cedar_pos
AYLEAIHIF	cedar_neg
AYLEAIHKF	cedar_pos
AYLEAIHSF	cedar_neg
AYLEAIHTF	cedar_neg
AYLEAIHYF	cedar_pos
AYNVTRMVSM	cedar_neg
AYQLYTLYPGK	prime_neg
AYQNQQFTKLK	prime_neg
AYQNQQFTK	prime_neg
AYQSIKVRI	cedar_pos
AYRDLQTRK	cedar_pos
AYSFQSLLY	cedar_neg
AYSFQSLLYL	cedar_neg
AYSFQSLLYLL	cedar_neg
AYVTPPGTGF	prime_neg
CAFAHGPLYLR	prime_neg
CAFAHGPLY	prime_neg
CAFRFADLR	prime_neg
CAFTRNIIK	prime_neg
CAIIVVVMR	prime_neg
CASSSSSFR	prime_neg
CATCAENFY	prime_neg
CCYFHFSPK	cedar_neg
CFLGSQNMYF	prime_neg
CGILAENTALY	cedar_neg
CGKVFSCSSY	prime_neg
CGYSGEPRPTY	prime_neg
CILGKLFTKK	prime_pos
CILGKLFTK	prime_pos
CISNAYITR	prime_neg
CISNVFMQR	cedar_pos
CISSCNPNL	cedar_pos
CIVCTVDLEF	cedar_neg
CLAFVLSWLV	prime_neg
CLAPCVRRLL	prime_neg
CLDLKILYL	cedar_neg
CLDPAQQNLY	prime_neg
CLFAKLIAI	prime_neg
CLFFGIPWK	cedar_neg
CLFLEIYTV	prime_neg
CLFPAMLCK	prime_neg
CLFPICSPA	prime_neg
CLFWSTASGV	prime_neg
CLISAKMPEV	prime_neg
CLLLDIVAPK	prime_neg
CLLMLLIPL	prime_neg
CLLSIDLFYV	prime_neg
CLLSYELSNI	cedar_neg
CLLTNWPSV	cedar_neg
CLLTTIYFFL	prime_neg
CLMHHLAQA	cedar_neg
CLNEYHLFL	cedar_pos
CLQELSLPNL	prime_neg
CLSIRITSI	cedar_neg
CLTGQRFTV	cedar_neg
CLVGLGLTY	prime_neg
CLYFIPYMFL	prime_neg
CLYFIPYMF	prime_neg
CLYGDVTLENL	cedar_neg
CMFCSEEFL	cedar_neg
CMGENQFNV	cedar_neg
CMLARLEVK	cedar_neg
CMQANSHYA	prime_neg
CMYEAVNEV	cedar_neg
CNGSEDGALAY	cedar_neg
CPFSQCTKSF	cedar_neg
CPGKPLNIF	cedar_neg
CPGKPLNIFRI	cedar_neg
CPIASSPCL	cedar_neg
CPIASSPCLPI	cedar_neg
CPILRGPDGL	prime_neg
CPMEIERIKI	prime_neg
CPNGGSSWM	prime_neg
CPNSGEQLQPA	prime_neg
CPVTGYWLEM	prime_neg
CQNMIRSHVR	prime_neg
CQPDLWKFAPV	prime_neg
CQQWLALFFV	cedar_pos
CQRESSCGTGY	prime_neg
CQYVVKQSQLK	prime_neg
CSAYLGLHY	prime_neg
CSCGQVLFAV	prime_neg
CSDSKLIGY	prime_neg
CSESTSCLF	cedar_neg
CSHSMRYFY	prime_neg
CSIQNDVPF	prime_neg
CSMCHVHPH	cedar_neg
CSNAAAAALDK	prime_neg
CSNFLLLAY	prime_neg
CSQDHDTQK	prime_neg
CSSTLLLPHY	cedar_neg
CSSTLYLPHY	cedar_neg
CSYGRVLFAV	prime_neg
CSYTFAYRTK	prime_neg
CTAGASSLLV	prime_neg
CTDELLGAA	cedar_neg
CTDTYMLELF	prime_neg
CTDTYMLEL	prime_neg
CTFSEVAAHY	cedar_neg
CTFYFSNMLEF	cedar_neg
CTIAVVNFL	cedar_pos
CTYEYWPSA	cedar_neg
CVAETMCYAY	prime_neg
CVDSPPPLFF	prime_neg
CVQPHYITV	cedar_neg
CVRVSGQGL	cedar_pos
CVVTEVFLL	cedar_neg
CVWRYYIFSV	prime_neg
CYDHVADQWEF	prime_neg
CYLNLALAVF	prime_neg
CYMEAVAL	prime_pos
CYMEAVALV	prime_neg
CYTADNEMEY	cedar_neg
CYWSLLSHPL	cedar_neg
DAAKWKANLR	prime_neg
DAALCRTYY	prime_neg
DAITGEASY	prime_neg
DANSFLQSV	prime_pos
DAVATFYLYM	prime_neg
DDIYPIDFY	cedar_pos
DEERIPVL	prime_neg
DEGKCVAETM	prime_neg
DENITTIQF	cedar_pos
DENLVGSEV	prime_neg
DEQIESMTY	cedar_neg
DFATPSLHTSV	cedar_neg
DFDTYDDQAY	prime_neg
DFLRNIPRSIF	cedar_neg
DGAILPFTPEF	cedar_neg
DGVGKSAL	prime_neg
DHCDNPFAEV	prime_neg
DHFETIIKY	cedar_neg
DHREIEGRVMF	cedar_pos
DHYAYSYYL	cedar_pos
DIFFLGLILF	cedar_neg
DIFQVVKAI	prime_neg
DISEYRVEHL	prime_neg
DLAGGTFDV	prime_neg
DLFHWKATI	prime_neg
DLGLAAFLAV	prime_neg
DLIEIFRLGY	prime_neg
DLQKFKFLK	prime_neg
DLSLIQKNR	prime_neg
DLSYTWNIPV	cedar_neg
DMAPEVVEAF	prime_neg
DMISFSIDRY	prime_neg
DMKARQKAL	cedar_pos
DMKARQKALV	cedar_pos
DMWSIEVICY	cedar_neg
DPEEVLVTV	cedar_neg
DPESDTLTL	cedar_neg
DPILPELTRLL	cedar_neg
DPSAAKNPKLM	prime_neg
DPSQRGCFTL	cedar_neg
DPVTEVTARM	prime_neg
DPYALVRLGI	cedar_neg
DQCKENHQFR	prime_neg
DRYAAVYRPL	prime_neg
DSDEYFNPA	prime_neg
DSEPLCLSY	cedar_neg
DSEPNRGILY	prime_neg
DSFKKVTLR	prime_neg
DSFKKVTLRR	prime_neg
DSFVGADLQK	prime_neg
DSLMCGTWYK	prime_neg
DSPDGSNGL	cedar_neg
DTASSSLAF	prime_neg
DTSPVAVAL	cedar_neg
DTVEYPYTSF	cedar_pos
DTYGVRLLFK	prime_neg
DVAAHLQPL	cedar_neg
DVCHIAFESK	prime_neg
DVFAWEPFV	cedar_neg
DVFKVIAYLK	prime_neg
DVIGWTSTY	prime_neg
DVIQQDELDSY	cedar_neg
DVKAIGPLV	cedar_neg
DVLDVHQAF	prime_neg
DVSDNEPDLYR	cedar_neg
DVSVQVER	prime_neg
DVWFQGERIAY	cedar_neg
DWIMVLVLPK	prime_neg
DYMIHIIEKW	cedar_pos
DYRQDEYYNF	cedar_neg
DYSFSISSI	cedar_neg
DYSFSISSIL	cedar_neg
EAAADETPA	prime_neg
EAALNNPKMY	prime_neg
EAFSLCWHS	prime_neg
EAGNNSRVPR	cedar_neg
EAMIETSCR	prime_neg
EAPDALSLL	prime_neg
EASGITYEY	cedar_neg
EEADFLLAY	cedar_neg
EECLWMAVL	cedar_neg
EEDTFSYLI	cedar_neg
EEFWLVDLL	cedar_neg
EEFWLVDLLP	cedar_neg
EEHAQNVSCAS	cedar_neg
EEKAASSLVSY	cedar_neg
EEKLIVVLF	cedar_neg
EELDGVAISTY	prime_neg
EELSATVPS	cedar_neg
EELSATVPSQ	cedar_neg
EEMEPLPVM	cedar_pos
EENANFYKIF	cedar_neg
EEQRYTCHM	prime_neg
EESGGAVAFF	cedar_neg
EETPPFSNY	cedar_neg
EEVTPILAI	cedar_neg
EEYQPATPRL	prime_neg
EEYYADAFDF	cedar_neg
EFCLKHFLI	prime_neg
EFVGYGQKFF	prime_neg
EGSLGISHTR	cedar_neg
EGWLHKPGEY	prime_neg
EHEEVVLEEL	prime_neg
EHIPESAGF	cedar_neg
EHLSCPDNFL	cedar_neg
EICGVGSTLVF	prime_neg
EIGMWHAKK	cedar_neg
EIKEDGVGF	prime_neg
EILPRLRLQK	prime_neg
EIPLIGLIPS	prime_neg
EKRGGYPLR	prime_neg
EKTSSGLYVFR	cedar_pos
ELAELLPRL	prime_neg
ELAGIGILTV	cedar_pos
ELATRGAQM	cedar_neg
ELDEETNLKF	prime_neg
ELDGLFRPY	cedar_neg
ELDPDIQLEY	cedar_neg
ELFDAAIVAGI	prime_neg
ELFDPNQSPQV	cedar_neg
ELKHILYHAF	prime_neg
ELLEQHYAK	prime_neg
ELLPRLFRV	prime_neg
ELLSESMVEYK	prime_neg
ELMRDINSM	cedar_pos
ELNARRCSF	cedar_neg
ELNKSLDAF	prime_neg
ELSEENIEFWI	prime_neg
ELSKEELPYYV	cedar_neg
ELWCRQPPY	prime_neg
ELWCRQPPYR	prime_neg
ELYDFLDYYY	prime_neg
EMDMHLSDY	cedar_neg
EMDTISEYIY	prime_neg
EMKRVFGFPV	cedar_neg
EMLIKPKEL	prime_neg
EMSAICQVY	cedar_neg
EMWKCQNMIR	prime_neg
ENDPIQGPV	prime_neg
ENITTIQFY	cedar_neg
ENVLHRTYTW	prime_neg
EPAGLRQEVL	prime_neg
EPAGLRQEV	prime_neg
EPAQAAQQS	prime_neg
EPCEETTSDM	prime_neg
EPEVVFLQF	cedar_neg
EPKPFLYVL	cedar_neg
EPKPLFPKLAF	cedar_neg
EPKPLFPKL	cedar_neg
EPKWDPFPL	cedar_neg
EPLERSKQM	prime_neg
EPLLIYSTHY	cedar_neg
EPLSYSLLQR	cedar_neg
EPPIFQQPFY	prime_neg
EPQGCFREELM	prime_neg
EPRSSINISAF	prime_neg
EPVGVVCRVY	prime_neg
EPVTATGSG	prime_neg
EPVTSCEAY	prime_neg
EQEERLQRL	prime_neg
EQMDFCWDPW	prime_neg
EQNFVSTSDIK	cedar_neg
EQYDVYMYQEV	cedar_neg
EQYSAVMGRSY	prime_neg
ERDPRTLTL	prime_neg
ERLDEGLWKE	prime_neg
ERRQKSSEV	prime_neg
ESAPINTPL	cedar_neg
ESDKEELVGY	prime_neg
ESDQLIAMTY	prime_neg
ESDQPDLSSF	prime_neg
ESDVSKGAPY	prime_neg
ESFSWLEEM	prime_neg
ESGGAVAFF	cedar_neg
ESLGYHCKYK	prime_neg
ESNCCIKHR	prime_neg
ESTAFSWPVY	prime_neg
ESYLKEFPK	prime_neg
ESYMCASNEPF	prime_neg
ETALAAFLFY	prime_neg
ETCTAGAGSL	prime_neg
ETDESLIYSF	cedar_neg
ETESEAEDY	prime_neg
ETMQCSELY	cedar_pos
ETMQCSELYHM	cedar_pos
ETPPFSNYNTL	cedar_neg
ETPQETYTK	prime_neg
ETPSPTPSY	prime_neg
ETTEEMKYVL	cedar_neg
ETVKNLLEF	cedar_neg
ETWELFPVK	prime_neg
ETWRETGISF	prime_neg
ETYTKVMNWK	prime_neg
EVADAATLTM	cedar_pos
EVHLHSEPF	prime_neg
EVIVPLSGW	cedar_pos
EVLPFFLFF	cedar_pos
EVLQFARAHA	prime_neg
EVLVEYPFF	prime_neg
EVMKKLPLS	prime_neg
EVPDGFTAVM	prime_neg
EVPDGFTAV	prime_neg
EVRALLTQY	prime_pos
EVRLLGIPF	prime_neg
EVSSSIYLHK	prime_neg
EVTPILAIR	cedar_neg
EVWVFNKNYK	prime_neg
EVYFGPCSPY	prime_neg
EWHDAISRK	prime_neg
EWVPEPPER	prime_neg
EYCKFSFLF	cedar_neg
EYESLVSEDF	cedar_neg
EYMLPFLEEI	prime_neg
EYVHLTYQDW	prime_neg
EYVPRFVFK	cedar_neg
EYYADAFDF	cedar_neg
EYYADAFDFY	cedar_neg
EYYSKNLNSF	cedar_pos
FAAGSAAGLY	prime_neg
FAEMHAYMGKF	prime_neg
FAERREARKY	prime_neg
FAFDAVSKPGL	cedar_neg
FAFQEYDSF	prime_pos
FAFVEFYHF	cedar_neg
FAHFHSGGM	prime_neg
FAIADTAYV	cedar_pos
FAISLTCGY	prime_neg
FAKNFHFKAVM	prime_neg
FAKNPHLHYI	cedar_neg
FALDITNLMPL	prime_neg
FALDRYYSV	prime_neg
FALGNVISA	cedar_neg
FALGNVISAL	cedar_neg
FALLQEEAHV	cedar_neg
FAQWRHDFVL	prime_neg
FARAHALMF	cedar_pos
FASDIPRIL	cedar_neg
FASGTSYHLSL	cedar_neg
FASLALARRY	cedar_neg
FASLALARRYL	cedar_neg
FASMPSSPPL	prime_neg
FASMPSSPP	prime_neg
FATDNYCHV	cedar_neg
FATPSLHTSV	cedar_neg
FAVGSYVYSV	cedar_pos
FAVWTLAETI	cedar_neg
FAVYRMKSAE	prime_neg
FAVYRMKSA	prime_neg
FAWEPFVAQF	cedar_neg
FAYRTKLER	prime_neg
FCGNTEPRSL	prime_neg
FCTSCPAGYYI	cedar_neg
FEAEFTQVA	cedar_neg
FEDKSVAYT	cedar_pos
FEFCEDDLW	cedar_neg
FEIQAVNGI	prime_neg
FEIRARTAA	cedar_neg
FEMDTISEYI	prime_neg
FFARLFVFQV	cedar_neg
FFCDVQQVIKL	cedar_neg
FFEMDTISEY	prime_neg
FFFFFFFFFF	prime_neg
FFFFFFFFFL	prime_neg
FFFFFFFFF	prime_neg
FFFFFLPVA	prime_neg
FFHETRQYKF	cedar_neg
FFKTSAQVVL	cedar_neg
FFLGLILFEL	cedar_neg
FFNATSYPEV	prime_neg
FFSIFPKCF	cedar_neg
FFSSVTVAL	cedar_neg
FFYLLDFTF	cedar_pos
FGASMTGIVY	cedar_neg
FGLLGNILLVI	cedar_pos
FGLSFTCPSV	prime_neg
FGMPPCLLAL	cedar_neg
FGPTTRSAAM	prime_neg
FGRAKLLGA	cedar_neg
FGVSAAIDY	prime_neg
FGYEHWALY	prime_neg
FHATNPLNL	cedar_neg
FHETRQYKF	cedar_neg
FHGESTQVQL	cedar_neg
FHLKGHEDL	cedar_neg
FHVIQILSF	prime_neg
FICAIIVVV	cedar_pos
FIDCYLLAI	cedar_pos
FIDFHTPPL	prime_neg
FIFNLINYYI	prime_neg
FIFNLINYY	prime_neg
FIFPSFLRVHA	cedar_neg
FIFSYVVAV	cedar_pos
FIFTLVEVWL	prime_neg
FIGPLMDAL	cedar_neg
FIGPLVFVGM	prime_neg
FIGQQFAVGSY	cedar_neg
FIHGGAIATV	cedar_neg
FIISRETLV	prime_neg
FIKSLPLVVKY	cedar_neg
FILAERSSLF	cedar_neg
FILDAVQRV	cedar_pos
FILDLFRTWNI	cedar_neg
FILEIINALPF	prime_neg
FILEIINAL	prime_neg
FILFLFFCFV	prime_neg
FILKLFFMGL	cedar_neg
FILLAVLLLL	prime_neg
FILLLFLTIFI	cedar_pos
FILMGLFRR	prime_neg
FILMGLPHV	cedar_neg
FILTPLGRY	prime_neg
FIMDTIGGREV	cedar_neg
FIMGISILL	cedar_pos
FINTGPEFPV	prime_neg
FIPAPAYYA	prime_neg
FIPKFVSFL	cedar_neg
FISGRFPYS	prime_neg
FISIFFFLEI	cedar_pos
FISNTVFRK	cedar_pos
FITPLCDVKV	prime_neg
FIVEALTLL	prime_neg
FIYQYYSSI	cedar_pos
FKAHLWTSKAF	prime_neg
FKLDTEKMPV	cedar_neg
FKVSAQGITM	cedar_neg
FLAADGHPA	cedar_neg
FLADENYRPL	prime_neg
FLAEHEYGL	cedar_pos
FLAEHLYAEA	prime_neg
FLAEHLYAEV	prime_neg
FLAKILKPL	cedar_neg
FLANQQNKY	prime_neg
FLAPLFLVLL	cedar_pos
FLAPTGVPV	cedar_neg
FLASLNICK	cedar_neg
FLASPSVPL	cedar_pos
FLATLGVPV	prime_neg
FLATRCLDEM	prime_neg
FLAYELLPAL	cedar_neg
FLCPGLLKEVY	cedar_neg
FLCRFKQLL	cedar_neg
FLCVFSITK	prime_neg
FLDEFMEGV	cedar_pos
FLDFMTKINDL	cedar_neg
FLDFNSIISI	prime_neg
FLDGRSNAHV	prime_neg
FLDPLAHEI	cedar_neg
FLDREQRESY	cedar_neg
FLEAGYICDA	cedar_neg
FLEEHKEFL	cedar_neg
FLEEMATYL	prime_neg
FLEGNEVGKTY	cedar_neg
FLEIYTVTV	cedar_pos
FLEIYTVTVV	prime_neg
FLEPQWYRV	cedar_neg
FLESELSIRI	cedar_pos
FLFAISVTT	prime_neg
FLFDAVVAWC	prime_neg
FLFDAVVAWCT	prime_neg
FLFDAVVAW	prime_neg
FLFELIPEP	cedar_pos
FLFFCFVLF	prime_neg
FLFFFWGVSL	prime_neg
FLFHTFLPIA	prime_neg
FLFHTFLPI	prime_neg
FLFIVIQLVL	prime_neg
FLFIVIQLV	prime_neg
FLFLELLHWF	cedar_neg
FLFLELLHWFK	cedar_neg
FLFLGLSGI	prime_neg
FLFMYLVMV	cedar_pos
FLFQDSKKI	cedar_neg
FLFRPVAMMV	prime_neg
FLFSGVNRL	prime_neg
FLFSLSAPM	prime_neg
FLFYPLDFT	cedar_pos
FLGAGLFLYF	cedar_pos
FLGASPYPGV	prime_neg
FLGDINPQHSW	cedar_neg
FLGEAWAQV	cedar_pos
FLGEYIPTV	cedar_pos
FLGHMVVSQM	prime_neg
FLGIFNTGF	cedar_neg
FLGIFNTGFKM	cedar_neg
FLGLTLVGV	prime_neg
FLGLTLVGVV	prime_neg
FLGTEDLYDY	prime_neg
FLGYIPKAWII	cedar_neg
FLHKGLSKPV	cedar_neg
FLHKGYVPC	cedar_neg
FLHQSSVPTL	prime_neg
FLHTVSKTRL	cedar_neg
FLIAFGHRV	prime_neg
FLIDFMFFESS	cedar_neg
FLIDIILISL	prime_neg
FLIEMVAAIPF	prime_neg
FLIISYVASL	prime_neg
FLILAFVAAA	prime_neg
FLILRGVLV	cedar_neg
FLIPIVFIS	prime_neg
FLIQTEQKL	cedar_pos
FLISAIQLA	prime_neg
FLIYLDVSV	cedar_pos
FLKHKMPLSL	cedar_neg
FLKRLELKPL	cedar_neg
FLLALYDSV	prime_neg
FLLAWMIPNV	prime_neg
FLLDDPLSTV	cedar_neg
FLLDEAIGL	cedar_pos
FLLDSCTKL	cedar_pos
FLLGKTSSV	prime_neg
FLLILFAEI	prime_neg
FLLLFLGMFL	prime_neg
FLLLVAAMI	cedar_neg
FLLLVGFLLL	prime_neg
FLLPSGMAL	cedar_pos
FLLQLPFRG	cedar_neg
FLLQYSEVAI	prime_neg
FLLQYSEVA	prime_neg
FLLRFLYTQL	cedar_pos
FLLRVEPQNL	prime_neg
FLLTAASPTI	prime_neg
FLLTDYALS	cedar_neg
FLLTSIIAI	prime_neg
FLLTSIIAIV	prime_neg
FLLYNLGLV	prime_neg
FLLYYGQDI	cedar_neg
FLMASISSF	cedar_neg
FLMASISSFL	cedar_pos
FLMASISSFLL	cedar_pos
FLMRVMDISY	cedar_neg
FLMRVMDISYL	cedar_neg
FLNDIFERI	prime_neg
FLNDLLSVL	cedar_pos
FLNEIPLFV	prime_neg
FLNMELLVV	prime_neg
FLNSCFFCI	prime_neg
FLNSCFFCIV	prime_neg
FLNVLFPLL	cedar_pos
FLPAYLNSL	prime_neg
FLPDLNVNA	cedar_pos
FLPGGALPSL	prime_neg
FLPIPNWEQ	cedar_neg
FLPRPPLPPSV	cedar_neg
FLPVTDASSV	cedar_neg
FLQEETLTQM	prime_neg
FLQEVNVCGV	cedar_pos
FLQEYVTLHK	prime_neg
FLQFRGNEV	cedar_neg
FLQKYTVKL	prime_neg
FLQPHMIGA	prime_neg
FLRLPDYAEV	prime_neg
FLRNIPRSI	cedar_neg
FLRNIPRSIF	cedar_neg
FLSASSNSF	cedar_neg
FLSCPLYRFSL	cedar_neg
FLSDHLYLV	cedar_pos
FLSDMPRSPM	prime_neg
FLSGGGPFSNL	cedar_neg
FLSGQRTVFL	prime_neg
FLSIILDHL	cedar_neg
FLSNFIILML	cedar_pos
FLSQEIIIKV	prime_neg
FLSQIHEAAV	prime_neg
FLSQKGQLYT	prime_neg
FLSQRVAFL	cedar_neg
FLSQRVAFLGL	cedar_neg
FLSSPAYFS	cedar_neg
FLSTHLKLFL	cedar_neg
FLSTKYRGYML	cedar_neg
FLSTVMDRV	cedar_neg
FLSVRPFPSV	prime_neg
FLSWYDRGVPF	prime_neg
FLTAHSLPL	cedar_pos
FLTSALWINV	prime_neg
FLTVFSHFM	cedar_pos
FLVCVVPDV	prime_neg
FLVFPFIAI	prime_neg
FLVGKPGSSM	cedar_neg
FLVLMPMKV	cedar_neg
FLVNKFSTL	cedar_neg
FLVYGVRPGM	cedar_neg
FLWRKTSKYM	cedar_neg
FLWSVFMLI	cedar_pos
FLYEKQHEL	cedar_pos
FLYELECFEG	prime_neg
FLYFMIPFFF	prime_neg
FLYFRDRLGDI	cedar_neg
FLYNLLTRV	cedar_pos
FLYSMGSIKFI	cedar_neg
FLYVLGRKK	cedar_neg
FMASILKGYRL	cedar_neg
FMASNDEGV	cedar_neg
FMATYFRQPT	prime_neg
FMDMAILVES	cedar_pos
FMDSVIFIL	cedar_neg
FMEAVSSKYSM	cedar_neg
FMFVNSLLL	cedar_pos
FMIDPPRAAV	prime_neg
FMIGYTSAL	cedar_pos
FMKWSISAFL	prime_neg
FMLLTQARI	cedar_pos
FMLVQACRSV	cedar_neg
FMLYLLTLM	cedar_pos
FMMIPLCSI	prime_neg
FMMPRIVDV	cedar_neg
FMMPRIVDVT	cedar_neg
FMPDFDLHL	cedar_pos
FMQQGCDIL	cedar_neg
FMQRLLGPQRV	cedar_pos
FMSESTSNI	cedar_neg
FMSFQSYLL	prime_neg
FMSFVPIPDT	prime_neg
FMSSHMKSV	prime_neg
FMSTMDVLV	cedar_neg
FMSTRFLLV	prime_neg
FMTKINDLEV	cedar_neg
FMVDTRGGSM	cedar_neg
FMVPRDPAL	cedar_neg
FNGDADRIVY	prime_neg
FNQLIYELYV	cedar_neg
FPAAAFPTA	cedar_neg
FPAAAFPTAS	cedar_neg
FPAESARLV	prime_neg
FPATVFGVSAA	prime_neg
FPCDFGPGEVH	prime_neg
FPDPPSSLDL	cedar_neg
FPETSFIAV	prime_neg
FPETSFIAVT	prime_neg
FPFIAISCS	prime_neg
FPFIAISCSY	prime_neg
FPFIGISCSC	prime_neg
FPFNIRPYSQM	prime_neg
FPGNQWNPV	cedar_neg
FPKKIQMLA	cedar_pos
FPKQDGGTQK	cedar_neg
FPLHEADPR	prime_neg
FPLPNQLEIAL	cedar_neg
FPLTASKVL	cedar_pos
FPPIRPATVPL	prime_neg
FPQGLPNEY	cedar_pos
FPRKSAFSL	cedar_neg
FPRYAGLMV	cedar_neg
FPSPSKTSLTL	cedar_neg
FPVHSWYNF	cedar_neg
FPVVNSHSL	cedar_neg
FPYPGMTNQ	cedar_neg
FPYSRRKFPA	prime_neg
FQANFSQTW	cedar_neg
FQAQHIAMA	cedar_pos
FQDDDQTRL	cedar_neg
FQETHLPI	prime_neg
FQHPYDQAHLL	cedar_neg
FQIDDKTFFV	prime_neg
FQLGLPLVFI	prime_neg
FQLNQSFEI	cedar_pos
FQMSIDMGFET	prime_neg
FQNYKQVPV	prime_neg
FQPSFSHLVAF	cedar_neg
FQPSFSHLV	cedar_neg
FQQEIQILK	cedar_neg
FQSAGETGQDL	prime_neg
FQTSEKKFYI	cedar_neg
FQYFRATYPL	cedar_neg
FRFFATPAL	cedar_neg
FRFFTRKSL	cedar_neg
FRHQAHWDRY	prime_neg
FRHSLVVPY	cedar_neg
FRICPIFVF	cedar_neg
FRLLHPHHPL	prime_neg
FRMFLTQGF	cedar_neg
FRQKTNLIL	cedar_pos
FRQLGTFKL	prime_neg
FRQSLYLKI	cedar_neg
FRRSKHPALL	prime_neg
FRRSKHPAL	prime_neg
FRSGLDSYV	cedar_neg
FRSIYLNTLL	cedar_pos
FRYLSLQDI	cedar_neg
FRYYRVSILL	cedar_pos
FSARVLKSY	prime_neg
FSATLAYFL	cedar_neg
FSCDGLGTGY	prime_neg
FSCTVENIFY	prime_neg
FSDKKVGTY	prime_neg
FSDKKVGTYV	prime_neg
FSDLSSLRL	prime_neg
FSDYERAEW	prime_neg
FSDYYDLSY	prime_neg
FSEFFIGPLM	cedar_neg
FSEFFLLALY	prime_neg
FSFDGWQISF	prime_neg
FSFPETQFIAV	cedar_neg
FSFPRSSEPF	cedar_neg
FSFSLDFLV	prime_neg
FSGEYIPTV	cedar_pos
FSGLRHHVK	prime_neg
FSGPARCPPPY	prime_neg
FSKDQFSEVY	prime_neg
FSKGLDLSTF	prime_neg
FSLARQFSL	cedar_neg
FSLPKSVPL	cedar_neg
FSLPKSVPLF	cedar_neg
FSLRACYHMK	prime_neg
FSLSTIHLRL	prime_neg
FSMAKTSTSL	cedar_neg
FSNFIFLRLK	prime_neg
FSPADGNPIL	prime_neg
FSPADGNPI	prime_neg
FSPEFSEFF	cedar_neg
FSPEFSEFFI	cedar_neg
FSQESPLDTF	prime_neg
FSQSSSLVIY	prime_neg
FSSDVLNLV	cedar_pos
FSSFMFGWHV	cedar_neg
FSSKSLLEV	cedar_neg
FSSRSLLDF	prime_neg
FSSSFPKPPSF	cedar_neg
FSSSFVEIVTI	cedar_neg
FSSYYEPWGY	prime_neg
FSVGYTVAK	prime_neg
FSVKTVLLL	prime_neg
FSVMIACNI	prime_neg
FSWRDSSFTEV	cedar_neg
FSYLIWSNPRY	cedar_neg
FTAAALAGH	cedar_neg
FTCPSVKNPI	prime_neg
FTDEKVKAY	cedar_neg
FTDLSGFQV	cedar_neg
FTEGCVQRYK	prime_neg
FTEPEVVFLQF	cedar_neg
FTGPCPMEI	prime_neg
FTGQFVSEEV	cedar_neg
FTGQYCDSRY	prime_neg
FTGTIPVMY	prime_neg
FTGTISVMY	prime_neg
FTLEGGHRA	cedar_neg
FTLERRWYNEI	cedar_neg
FTLLLRNQK	prime_neg
FTLMYEERAV	cedar_pos
FTLSYPYDK	prime_neg
FTLSYPYGSK	prime_neg
FTLTVTSLYL	prime_neg
FTLTVTSLY	prime_neg
FTLVEVWLV	prime_neg
FTMVILYVVY	prime_neg
FTMVISYVVY	prime_neg
FTNFWGLLI	prime_neg
FTNYSVQLLAY	prime_neg
FTQLLVFRY	prime_neg
FTSDVVRQY	prime_neg
FTSEVTYDL	prime_neg
FTSKHHFSF	cedar_neg
FTTDNLCFVSL	cedar_neg
FTVPNLLPR	cedar_neg
FTWSMKTSSSM	prime_neg
FVADWAGTF	cedar_neg
FVAGAVGPHK	prime_neg
FVALSTCHEL	cedar_neg
FVASRTRPDY	prime_neg
FVDENVDRM	prime_neg
FVFKLYYFEI	cedar_neg
FVGADLKNFK	prime_neg
FVGADLQKFK	prime_neg
FVGALSFSI	cedar_pos
FVHLSNVKV	cedar_neg
FVIGYDPPSA	cedar_neg
FVIRPTAVIL	prime_neg
FVIRPTAVI	prime_neg
FVLAVKRTV	cedar_neg
FVLGWIKVPV	prime_neg
FVLNGGGEV	cedar_neg
FVLTCIIIVCF	cedar_neg
FVLVGSLIVAF	prime_neg
FVPPVSPPSY	cedar_neg
FVQCGTLLPV	prime_neg
FVRCRKATAEV	prime_neg
FVRTNSLVFR	cedar_neg
FVRYHYNATL	prime_neg
FVSALCMFL	cedar_neg
FVSFVNMNSLL	cedar_neg
FVSKDISSGSV	cedar_neg
FVSTSDIKSM	cedar_pos
FVTETPLEV	cedar_pos
FVTFSCHGADK	cedar_neg
FVTPLVLRSHK	prime_neg
FVVPYMIYLL	cedar_pos
FVYQCFEGYI	cedar_neg
FVYVFITHL	cedar_pos
FWCPFGFIL	prime_neg
FWLFWGLTY	cedar_neg
FWLFWGLTYI	cedar_neg
FWYTHNLIF	cedar_pos
FWYTHNLIFV	cedar_pos
FWYTHNLIFVF	cedar_pos
FWYTHNLI	prime_neg
FWYYAKVDL	cedar_pos
FYCRPHFTI	cedar_neg
FYFFHETRQY	cedar_neg
FYFSNMLEF	cedar_neg
FYFSNMLEFY	cedar_neg
FYGGILWCFL	prime_neg
FYGGILWCF	prime_pos
FYGKTILWF	cedar_pos
FYHFQDATSW	cedar_neg
FYNDIILMV	cedar_pos
FYNQEEYVR	prime_neg
FYPGMLQRR	cedar_neg
FYQSVISNPF	cedar_neg
FYQVGKRCMEI	prime_neg
FYTAVSRPGR	prime_neg
FYYNCAFTRNI	prime_neg
GAASESPSLK	prime_neg
GACCPVCLK	cedar_neg
GACCPVCLKK	cedar_neg
GADGVGKSA	cedar_pos
GADGVGKSAL	cedar_pos
GAEGYEDECL	prime_neg
GAFAKKLGK	prime_neg
GAFYYNCAFTR	prime_neg
GAGGVQSIAK	prime_neg
GAILPFTPEF	cedar_neg
GALCAAAAL	prime_neg
GAPPLGRVL	prime_neg
GAQSWLWFV	cedar_pos
GASAPATAK	prime_neg
GASMTGIVY	cedar_neg
GASSATAVL	cedar_neg
GASSMCCQK	prime_neg
GATDEKGPVL	prime_neg
GATDEKGPV	prime_neg
GATNPYMVY	prime_neg
GAVAGEGRAL	prime_neg
GAYFEAMEQL	prime_neg
GDFGLATEK	cedar_neg
GEEDGAGGHSL	cedar_pos
GENGFILTPL	prime_neg
GEQDHTFRV	cedar_neg
GEYFTHQIR	cedar_neg
GEYISCVAW	prime_neg
GFAERREAR	prime_neg
GFAFVEFYHF	cedar_neg
GFFFFFLPV	prime_neg
GFLCVFSITK	prime_neg
GFTDRREDR	prime_neg
GFTVPNLLPR	cedar_neg
GGAPPLGRVL	prime_neg
GIIAAQPPNFL	cedar_neg
GIILDVPEI	prime_neg
GIILDVPEIV	prime_neg
GIIPPSVQV	cedar_neg
GIKFVKHLGK	cedar_pos
GINPSLHTPM	prime_neg
GIPDEVLESI	prime_neg
GIPENSFNV	cedar_neg
GIQTFCSRV	cedar_neg
GITAGTILV	prime_neg
GITTSVFPV	cedar_neg
GITYEYRPSK	cedar_neg
GLAAIDLIL	cedar_neg
GLAEFQDNV	cedar_neg
GLAFDMDEI	cedar_neg
GLAMAGSLV	cedar_neg
GLAMAGSLVF	cedar_neg
GLAMAGSLVFL	cedar_pos
GLAPGLPSV	cedar_neg
GLAQEYTTSL	cedar_neg
GLAYEIEPI	cedar_neg
GLDALLTHGV	prime_neg
GLDGYREYSL	prime_neg
GLDLSTFPIAL	prime_neg
GLDLSTFPIA	prime_neg
GLDLSTFPI	prime_neg
GLEFQIFNV	prime_neg
GLFGCLFECGI	cedar_neg
GLFGDIYLAI	prime_pos
GLFGDIYLA	prime_neg
GLFLRLPDYA	prime_neg
GLFRPYGSTV	cedar_neg
GLGEEQNHGV	cedar_neg
GLGGAVLLSV	prime_neg
GLGKGTYGV	cedar_pos
GLGPGFSSY	cedar_pos
GLGPKDTYV	cedar_neg
GLGSPTVYK	cedar_neg
GLHVFNLPK	prime_neg
GLIEPSPPSA	cedar_neg
GLIPFFMVV	cedar_pos
GLIPPPLAPV	prime_neg
GLIWVVLIL	prime_neg
GLKQFSFPR	cedar_neg
GLLDEAKRLLY	cedar_neg
GLLDEDFYA	cedar_pos
GLLHGCIYAI	prime_neg
GLLHGCIYA	prime_neg
GLLHMCQPDL	prime_neg
GLLIYCQAGV	prime_neg
GLLKDCIFDL	prime_neg
GLLLQVLFWL	prime_neg
GLLNSIWPL	cedar_pos
GLLPVLSWLL	cedar_neg
GLLSDDLLLK	prime_neg
GLMDLLEEKV	prime_neg
GLMEGKDPANT	prime_neg
GLMFMMIPL	prime_neg
GLMGTEQLF	cedar_neg
GLMKDIVEA	prime_neg
GLMSNTPTPR	cedar_neg
GLMVIAWFI	cedar_neg
GLNETIAKL	prime_neg
GLNVPVQSNK	cedar_neg
GLPAEGVSEV	cedar_neg
GLPFMCHAEV	prime_neg
GLPHAFFLV	prime_neg
GLPNHGATFKV	cedar_neg
GLPSGPAPRK	cedar_neg
GLPWSFLGWL	cedar_neg
GLQNASFVLY	prime_neg
GLRERMGLSY	cedar_neg
GLRTTGQLR	prime_neg
GLSFFILSL	cedar_pos
GLSFHPSGNY	prime_neg
GLSFTCPSV	prime_neg
GLSLYTTEM	cedar_neg
GLSSSVIYFL	prime_neg
GLSWLPPPL	prime_neg
GLSYCLPPTF	cedar_neg
GLTEDAAYK	prime_neg
GLTLGACLSL	prime_neg
GLTSFFIAI	cedar_pos
GLVDEQQEV	prime_neg
GLVEALHEVL	prime_neg
GLVEALHEV	prime_neg
GLWRPAWRCV	cedar_neg
GLYAMGPLAV	prime_neg
GLYLELTPK	cedar_neg
GLYQALQSRL	prime_neg
GLYVFRNER	cedar_pos
GMAGQIPPL	cedar_neg
GMDCNREEYL	cedar_neg
GMDGAYLNGY	prime_neg
GMFEAGDCQV	cedar_neg
GMGPLLAMV	cedar_pos
GMGVSGSGK	prime_neg
GMIGSFSVRL	prime_neg
GMLCAENPEV	prime_neg
GMLCSFQTPDA	cedar_neg
GMLKFVKEYV	prime_neg
GMLKSRCEL	prime_neg
GMLKSRCELV	prime_neg
GMLRLTSGRK	prime_neg
GMMGPPGPL	prime_neg
GMMTTQQAGYV	cedar_neg
GMNSIEPAK	cedar_neg
GMNWRPILTI	cedar_neg
GMPKVLYST	cedar_neg
GMPPCLLAL	cedar_neg
GMVKAALEAI	cedar_neg
GMYASSYIILA	cedar_neg
GMYASSYIIL	cedar_neg
GNSSGALLK	prime_neg
GNVNADSVVY	prime_neg
GPAPVGTLSF	cedar_neg
GPAVLLSFGL	prime_neg
GPEELGLPM	prime_pos
GPFRNADVEM	prime_neg
GPGGAGTAPL	prime_neg
GPLDRKSRDL	cedar_neg
GPLYLRPPV	prime_neg
GPPDRCQPA	cedar_neg
GPPQCPPQSPL	prime_neg
GPPQPGPPL	prime_neg
GPPSLLWMNL	cedar_neg
GPQTVWTGA	cedar_neg
GPQTVWTGAW	cedar_neg
GPREALSHL	prime_neg
GPRFVRCRKA	prime_neg
GPRFVRCRKAT	prime_neg
GPRGGQALL	prime_neg
GPRGLDQLREL	cedar_neg
GPRLLLPCPM	cedar_neg
GPRNAPAAK	prime_neg
GPRWRSWLV	cedar_neg
GPSPGSLPQPI	prime_neg
GPSWGLSLM	prime_neg
GPTFNCLLDM	cedar_neg
GPYAEHYLMPF	prime_neg
GQALAEFAAL	prime_neg
GQALAEFAA	prime_neg
GQAQTGQPAGL	prime_neg
GQAQTGQPA	prime_neg
GQARQSRPV	prime_neg
GQFEPLETTA	cedar_neg
GQFEPLETTAK	cedar_neg
GQFLTPNSH	cedar_pos
GQGSFSWTL	prime_neg
GQKGNIGPPGF	cedar_neg
GQMARSASE	prime_neg
GQQFFFFFFF	prime_neg
GQSAKVLSVK	prime_neg
GQVLFAVYRM	prime_neg
GQWGFSHGA	cedar_pos
GQWHSVSFSA	prime_neg
GRALEVKAR	prime_neg
GRIAFFLKY	cedar_pos
GRKLFGTHF	cedar_pos
GRKLFGTHFY	prime_pos
GRMRSLEAL	cedar_neg
GRQSWSLYV	cedar_pos
GRRLAALPM	prime_neg
GRTGAGKSFL	cedar_neg
GRWALHSAF	cedar_neg
GSAPAVPEAF	cedar_neg
GSAPSLLHQR	prime_neg
GSGEYLSLSFK	prime_neg
GSILAYLVV	cedar_pos
GSIRISSMR	prime_neg
GSKRAVTK	prime_neg
GSLDVLMAV	cedar_neg
GSLHSGTAK	cedar_neg
GSNKKRKFSK	prime_neg
GSSFHALEEK	cedar_neg
GSSPFQHLEK	cedar_neg
GSTCSAHPV	prime_neg
GSTEQCAFCK	cedar_neg
GSTLLASFK	prime_neg
GSVINQGPM	prime_neg
GSVSFGTVY	cedar_neg
GSYECHVGIY	prime_neg
GSYPAQGPRF	prime_neg
GSYVRTLVY	prime_neg
GSYVYSVAK	cedar_neg
GTADTKVHF	prime_neg
GTAPLGTLR	prime_neg
GTAPSTTNSV	prime_neg
GTAWLEWWHV	cedar_neg
GTCKNIVGSY	cedar_neg
GTFFVLAYY	prime_neg
GTFSVLAYY	prime_neg
GTGEYNYSK	prime_neg
GTGKVTVEY	prime_neg
GTHFYPLIGR	prime_neg
GTISSASFY	prime_neg
GTKAATAAAR	cedar_neg
GTKKDVDVLK	cedar_pos
GTKPNPHVY	cedar_neg
GTLVRCAKAK	cedar_neg
GTNAFLPMCR	prime_neg
GTSAPRKKK	prime_pos
GTSSLIIYK	cedar_neg
GTSSLIIYKN	cedar_neg
GTVQTGMDTSK	cedar_neg
GTYVRVTVQAR	cedar_pos
GVADVLLYR	cedar_pos
GVAVMKFKNPL	cedar_neg
GVCNLDEHLK	cedar_neg
GVFDGAASV	cedar_neg
GVFQKYPETLV	prime_neg
GVGPGRISK	prime_neg
GVGPRFVRCRK	prime_neg
GVINAEFML	prime_neg
GVISSFVHV	prime_neg
GVISSLLKY	prime_neg
GVITKALYK	cedar_neg
GVKWHTAVIY	prime_neg
GVLELSFPQA	prime_neg
GVLPLSPSV	cedar_neg
GVLRPLCSL	prime_neg
GVLYVVRSLY	prime_neg
GVPGQTGLK	prime_neg
GVQPPETPR	prime_neg
GVRLSFSGPAL	cedar_neg
GVSKIIGGNPK	cedar_neg
GVSVFTLTADR	cedar_neg
GVWALPDPI	prime_neg
GYQLSLSAVF	prime_neg
GYSGEPRPTYF	prime_neg
GYVDVVKEL	prime_neg
GYWFVNFETK	cedar_neg
GYYLEGWRFL	cedar_neg
HACDTDLRGWY	prime_neg
HAEAGLCAGY	prime_neg
HAFLSQGSSPY	prime_neg
HALAFPQAR	prime_neg
HAPALDAPL	prime_neg
HAPPPEPPPL	prime_neg
HATPLPVTSL	prime_neg
HDLGRLHSC	cedar_pos
HEIHIGYLEY	cedar_pos
HEIHIGYLEYV	cedar_pos
HELMTLHGF	cedar_neg
HELMTLHGFM	cedar_neg
HESRTNTAI	cedar_pos
HESRTNTAIL	cedar_pos
HFPVYTLGF	prime_neg
HFSKKCSRALL	cedar_neg
HFTSKHHFSF	cedar_neg
HGLYKDLYAY	prime_neg
HHWQSTIGM	cedar_neg
HIAKSLFEV	cedar_pos
HIDDSDSITV	cedar_neg
HIDKWCLDLK	cedar_neg
HIFKICGQHTK	cedar_neg
HIHCVNPPL	cedar_pos
HIIRLMLEY	cedar_pos
HIKAQSIISK	cedar_neg
HIKIEPVAI	cedar_neg
HIKLDSSAQF	prime_neg
HIMPDTAEI	cedar_neg
HINTVMEVK	prime_neg
HIQPHLASV	cedar_neg
HIVEISTPV	cedar_pos
HIVHTGEKPYK	prime_neg
HIVHTGEKPY	prime_neg
HIVRIGDLK	cedar_neg
HIVTYYPGK	cedar_neg
HIVTYYPGKK	cedar_neg
HIYEGQITAL	cedar_neg
HIYIGIHMCV	cedar_neg
HLAAQFSSDVL	cedar_neg
HLARHRHLM	cedar_neg
HLATHFNFLI	prime_neg
HLEDFLLHI	cedar_neg
HLEKLCHGLY	prime_neg
HLFCVFYGL	prime_neg
HLGMSCHCK	cedar_neg
HLGNNRIFYV	prime_neg
HLGVFSSYY	prime_neg
HLHCYRSSF	cedar_pos
HLIDSNTLQV	cedar_pos
HLIELNIENA	prime_neg
HLKILFLPL	cedar_neg
HLLHHCFQPL	prime_neg
HLLPYFCIIYM	cedar_neg
HLLSVEYQI	cedar_pos
HLMAPISLQV	prime_neg
HLMCVKDSNI	prime_neg
HLMDGDLGL	cedar_pos
HLMWLERLY	cedar_pos
HLNGLLREV	cedar_pos
HLNHDSVWNFY	cedar_neg
HLNRAMLHK	cedar_neg
HLQATLFLEV	prime_neg
HLQLERINVY	prime_neg
HLRAWFVSL	cedar_neg
HLRIYTGEKPY	cedar_neg
HLSHQAHRY	prime_neg
HLSPGELHKEV	cedar_neg
HLTCLLLWV	prime_neg
HLYAYHEEL	cedar_neg
HLYDIPGSTY	cedar_neg
HLYDLESGMCI	cedar_neg
HLYRCRLSSL	cedar_neg
HMCQPDLWKF	prime_neg
HMCVYSYIHMY	cedar_neg
HMHIYPIVV	cedar_neg
HMIVVSIAY	prime_neg
HMMGFRTQEV	prime_neg
HMSSYIASL	prime_neg
HMTEVVRHC	cedar_pos
HPAPPAPPPA	cedar_neg
HPFMTDEEY	cedar_pos
HPGRPGEVI	prime_neg
HPHHYTRRRI	cedar_neg
HPLKNGDIL	cedar_neg
HPMAGAHEKTA	prime_neg
HPPSTLLTTLM	prime_neg
HPPSTLLTTL	prime_neg
HPQASSAVGF	cedar_neg
HPRAVTGFLW	cedar_neg
HPREANFKLKL	prime_neg
HPREANFKL	prime_neg
HPSAQISPT	prime_neg
HPSLCAHPPV	prime_neg
HPSPDLPGTHL	cedar_neg
HPVLNLRRL	prime_neg
HPWLELSDVHL	cedar_neg
HPYDQAHLL	cedar_neg
HQFHVHPLL	cedar_neg
HQGRELQAM	prime_neg
HQMLLQTCQDF	cedar_neg
HQNPVTGLLL	cedar_pos
HQRMHTGEK	cedar_neg
HRARTCRCR	prime_neg
HRATPVFLV	prime_neg
HRTAWWGKV	prime_neg
HRYFFFVAM	cedar_neg
HSASTPETR	prime_neg
HSCVMASLR	cedar_pos
HSDGAILPF	cedar_neg
HSDVFALST	prime_neg
HSEYSSFFY	prime_neg
HSHFWDNSK	cedar_neg
HSKPEDTDAW	cedar_neg
HSLHLSFCF	prime_neg
HSLQAEHRLLK	prime_neg
HSLSSFRIHER	cedar_neg
HSPFTATSL	cedar_neg
HSRKSTMSF	prime_neg
HSRNTHLGK	cedar_neg
HSRNTHLGKK	cedar_neg
HSRNTHLGKKK	cedar_neg
HSSKKVMRTK	cedar_neg
HSSSGSSLTLF	cedar_neg
HSVSSAFKK	cedar_pos
HSWRGVAQHL	prime_neg
HSYKCHLVLR	prime_neg
HSYSELCTW	cedar_neg
HTAKDSFECK	prime_neg
HTFNCRMFMK	cedar_neg
HTIPQAYWTK	prime_neg
HTLLLWEHNR	cedar_pos
HTRHYALYR	cedar_neg
HTSYGRSLR	prime_neg
HTSYGRSLRY	prime_neg
HVADQWEFK	prime_neg
HVFPETSFI	prime_neg
HVHRLCAVRCL	cedar_neg
HVIQILSFV	prime_pos
HVKITDFGRAK	cedar_pos
HVKITDFGR	cedar_pos
HVMLQIINIV	cedar_neg
HVQIAWHIYR	prime_neg
HVSDMSVVL	prime_neg
HVSPGASKM	prime_neg
HVVTISSLL	prime_neg
HVYYFFSKR	cedar_neg
HWQSTIGML	cedar_neg
HYAALRELI	cedar_neg
HYHLANDIYF	cedar_neg
HYIPTDSECR	prime_neg
HYTAQIILAL	cedar_neg
HYYRRRHMAAI	prime_neg
IAAGFVTEIK	prime_neg
IAAHTRYAL	prime_neg
IAAISEQVRF	cedar_neg
IAAQPPNFL	cedar_neg
IAASRSVVM	cedar_neg
IACNIRELHR	prime_neg
IAISCSYGQV	prime_neg
IAKYIVPYMK	cedar_neg
IALDYEWGTV	prime_neg
IAMAVLYLA	cedar_pos
IAMDVTEGL	cedar_neg
IASPIKELL	cedar_neg
IAVSSCILAK	cedar_neg
IAYAPEPNQK	cedar_neg
ICEENSLPY	prime_neg
ICVQRDPPGL	prime_neg
IEHNIRNAKY	cedar_neg
IEVEVNEI	prime_neg
IEYNAIKEIL	prime_neg
IEYNAIKEI	prime_neg
IFCGNTEPR	prime_neg
IFFGEISSSK	prime_neg
IFFLGLILF	cedar_neg
IFFLGLILFEL	cedar_neg
IFKKVYLLLK	prime_neg
IFLGSFYLMNL	prime_neg
IFQEMFDKHYK	cedar_pos
IFQLSSLNL	cedar_neg
IFSATLAYFL	cedar_neg
IFWYTHNLIF	cedar_pos
IGDFGLATEK	cedar_neg
IGMLKSRCEL	prime_neg
IGVKNPRGIL	prime_neg
IGWSHFIGWLV	prime_neg
IHLGQMALSL	prime_neg
IHYTAQIILAL	cedar_pos
IHYTAQIIL	cedar_pos
IIGSVSKEK	cedar_neg
IIKFVNDTK	prime_neg
IILDVCSSGL	cedar_neg
IILDVPEIVI	prime_neg
IILDVPEIV	prime_neg
IILMLVTNR	cedar_neg
IILQAVNFPFL	prime_neg
IILQAVNFPF	prime_neg
IILVAVPHV	cedar_pos
IIMLSSNVINF	cedar_neg
IINALPFII	prime_neg
IINALPFIISI	prime_neg
IINEPIDLK	cedar_neg
IINRTPWSL	prime_neg
IIQARFEEV	cedar_neg
IIQEYKKFTK	cedar_neg
IISAYKHMK	prime_neg
IISDGGCTCPV	cedar_neg
IISNIQDTQV	cedar_neg
IITYRNIFK	prime_neg
IIVGVGGAYF	prime_neg
IIVGVGGAY	prime_neg
IIYKEGDVEK	prime_neg
IKLIPGVSTT	cedar_neg
ILAALFLGL	cedar_pos
ILAALFLGLGV	cedar_pos
ILAELELSRRL	cedar_neg
ILAENTALY	cedar_neg
ILAENTALYF	cedar_neg
ILAFVAAAV	prime_neg
ILALAKETQFW	cedar_neg
ILAMRLWVIRV	cedar_neg
ILAPEAVGSGI	cedar_neg
ILAQLSDMHL	prime_neg
ILASWYRIYSK	cedar_neg
ILCETCLIV	cedar_pos
ILCSIQGVK	cedar_neg
ILCVTTADPY	prime_neg
ILDFRWVPPV	prime_neg
ILDGGHEDASL	cedar_neg
ILDGRDGHEV	prime_neg
ILDKVLVHL	cedar_pos
ILDSASHHCPL	cedar_neg
ILDTAGKEEY	cedar_neg
ILDTAGREEY	cedar_neg
ILDVCSSGL	cedar_neg
ILEESENLY	prime_neg
ILEIINALPFI	prime_neg
ILENPFFSI	cedar_neg
ILENPFFSIF	cedar_neg
ILFAALTFFL	prime_neg
ILFDSLTRECV	cedar_neg
ILFEEANGRL	cedar_neg
ILFLFFCFVL	prime_neg
ILFLFFCFV	prime_neg
ILFLIISYVA	prime_neg
ILFLIISYV	prime_neg
ILGEQVVHT	cedar_neg
ILGEQVVHTV	cedar_neg
ILGEQVVHTVL	cedar_neg
ILGIFNEFV	cedar_pos
ILGNALPLV	prime_neg
ILHFQNPGY	cedar_neg
ILILYLLSIL	prime_neg
ILILYLLSI	prime_neg
ILIPSTGSV	prime_neg
ILITGQFYDR	cedar_neg
ILITQVLGL	cedar_pos
ILIVMFPFL	cedar_pos
ILKNLCLELYL	cedar_neg
ILKQNYFSV	cedar_neg
ILLAVLQEI	cedar_neg
ILLDELKPA	prime_neg
ILLDSTWNL	prime_neg
ILLDWAANI	cedar_pos
ILLENPVVTL	prime_neg
ILLIHCDAYL	prime_neg
ILLLFENHV	prime_neg
ILLLFLTIFI	cedar_pos
ILLMTVTSI	prime_neg
ILLRRLLSSA	cedar_neg
ILLTCEPTV	prime_neg
ILLTLVANL	prime_neg
ILLVVKFCNV	prime_neg
ILMDSNMHVK	prime_neg
ILMEHSHKL	prime_neg
ILMGLFRRSK	prime_neg
ILMHGLVSL	cedar_pos
ILNAMIAKI	cedar_pos
ILNASNVKTF	cedar_neg
ILNVDIFTL	cedar_pos
ILPDAGQTV	cedar_pos
ILPELTRLL	cedar_neg
ILPFTPEFL	cedar_neg
ILPFTPEFLV	cedar_neg
ILPKVLILI	cedar_pos
ILPRLRLQK	prime_neg
ILQDGFLYV	cedar_pos
ILQSNPLLEV	cedar_neg
ILRLHYMVK	prime_neg
ILRTLQQIKK	cedar_neg
ILSEIELFRV	prime_neg
ILSGGRTLQI	cedar_neg
ILSPIDISGQV	cedar_neg
ILSPLQDGTK	cedar_neg
ILSPSAHEL	cedar_pos
ILSSDGKPFK	prime_neg
ILSTLPYTI	prime_neg
ILTDIEEKV	cedar_pos
ILTGLNYEV	cedar_pos
ILTPVLNPI	cedar_neg
ILTSSDGGEPV	cedar_neg
ILVIFSYTYI	prime_neg
ILWIFSIYL	cedar_pos
ILWRQDINL	cedar_pos
ILWYAPESL	cedar_neg
ILWYVFRLAGI	cedar_neg
ILYEAYVMA	prime_neg
ILYEAYVMAS	prime_neg
ILYEAYVMASV	prime_neg
ILYFFYLDEK	prime_neg
IMAHCILDL	cedar_neg
IMAPANFFV	prime_neg
IMDQVPFSV	cedar_pos
IMLSSNVINF	cedar_neg
IMPGNSFAV	cedar_neg
IMPNFPPQA	cedar_neg
IMQPSVVIPA	cedar_neg
IMQTLAGELY	cedar_pos
IMRTYTYEI	cedar_pos
IMSKELWPV	cedar_neg
IMSSSLFNL	cedar_pos
IMVDGELY	prime_neg
IMVRDTRCVY	prime_neg
IMYLTGMVNK	cedar_neg
IPAEHINQA	cedar_neg
IPAFDQRSGL	cedar_neg
IPAMHINQA	cedar_neg
IPASVSAPK	cedar_neg
IPATGQAKEL	cedar_neg
IPAVKLNKL	cedar_neg
IPAVKLNKLL	cedar_neg
IPAWTGSSL	prime_neg
IPDEVKLIVF	prime_neg
IPDEVKLIV	prime_neg
IPDFRNSVL	prime_neg
IPDSIALIQQL	cedar_pos
IPEPKWDPFPL	cedar_neg
IPINPRRCL	cedar_pos
IPLENQDKF	cedar_neg
IPLMHLATDL	prime_neg
IPLSDNTIF	cedar_pos
IPMSPDGLFPA	prime_neg
IPMSPDGLF	prime_neg
IPNSADNVPL	prime_neg
IPQDGKKVAW	prime_neg
IPRSIFSSDL	cedar_neg
IPSGAYEGGAL	prime_neg
IPSSQKVIF	cedar_neg
IPTHTQMTTSA	cedar_neg
IPTLSPQISL	prime_neg
IPWQVTEQQQL	prime_neg
IPYMFLSEWI	prime_neg
IQAAYVHVI	cedar_neg
IQANALPLM	cedar_neg
IQASMFDQK	cedar_neg
IQDLLCDCMLV	prime_neg
IQDQIQNCI	cedar_neg
IQFFLFAISV	prime_neg
IQINSHCFVV	cedar_neg
IQKNRMALF	prime_neg
IQMFTIVLVSY	cedar_pos
IQQKWRHYYR	prime_neg
IQQSRAPLVL	prime_neg
IQSLITANEQF	prime_neg
IQVFWIAPPV	cedar_neg
IQVKTLMVK	cedar_neg
IQVWEALLTL	cedar_neg
IQYENKEKL	prime_neg
IQYLELNRLV	cedar_neg
IRLYQFRLIV	cedar_pos
IRLYQFRLIVI	cedar_pos
IRMKHCVMV	cedar_neg
IRTLGRTGDL	prime_neg
IRVAKYGKTL	prime_neg
ISANSPYISY	prime_neg
ISAYKAPRDK	prime_neg
ISCSCGQVL	prime_neg
ISCSYGRVL	prime_neg
ISFENLDTA	cedar_neg
ISGSSSPLFNK	prime_neg
ISHIVTYYPGK	cedar_neg
ISIQRAQPL	cedar_neg
ISISLNNAVI	prime_neg
ISISLNNAV	prime_neg
ISISSEQTFY	prime_neg
ISLISRLSF	prime_neg
ISLNNAVIEL	cedar_pos
ISNEINWPEK	cedar_neg
ISNVGPWRK	prime_neg
ISPILENPFF	cedar_neg
ISRMSSKAMF	prime_neg
ISSAATPYR	prime_neg
ISSFVHVEQY	prime_neg
ISSMRFCPF	prime_neg
ISVMYQGNTY	prime_neg
ISYLMIALM	cedar_neg
ISYLMIALMVV	cedar_neg
ITAEIFMEK	cedar_neg
ITAPSLSGK	cedar_neg
ITCQSLRSPMY	cedar_pos
ITDAHELGVA	cedar_neg
ITDAHELGV	cedar_neg
ITDFGRAKL	cedar_pos
ITDVDELPIF	prime_neg
ITEEPILMTY	cedar_neg
ITEPSIAEY	prime_neg
ITFDDYIACFV	cedar_neg
ITFQSWPNSK	prime_neg
ITFRIPVSR	prime_neg
ITLFNGLSCK	prime_neg
ITMQLMNREK	cedar_neg
ITMTDNQRK	cedar_neg
ITNLLFAIPY	cedar_neg
ITNQMSIDK	prime_neg
ITQKYDFFFY	cedar_neg
ITRKNSRTPL	cedar_neg
ITRTVSANTV	cedar_neg
ITSFIIERK	prime_neg
ITSSAELLK	prime_neg
ITVARCMKMAY	cedar_pos
ITYEYRPSKA	cedar_neg
ITYEYRPSK	cedar_neg
ITYRNIFKK	prime_neg
IVAADLIMTL	cedar_neg
IVAPKLRPV	prime_neg
IVCTVDLEF	cedar_neg
IVDDIGHGV	prime_neg
IVFGVSQPDV	cedar_neg
IVFSKDQFSEV	prime_neg
IVGVGGAYF	prime_neg
IVIGVFLLF	prime_neg
IVILVVTGV	cedar_neg
IVIQQKWRHYY	prime_neg
IVMEYLAFL	cedar_neg
IVMTDAGRL	cedar_neg
IVSILFLIISY	prime_neg
IVTYYPGKK	cedar_neg
IVYSTYSQK	prime_neg
IWDDPWFFR	prime_neg
IWISKVGPWR	prime_neg
IWVVLILDGR	prime_neg
IYAGTTRFF	prime_neg
IYCVLLTFLK	prime_neg
IYDRFGQEI	cedar_neg
IYFPAAQTM	cedar_neg
IYGFYNECKR	prime_neg
IYIGVSVPI	cedar_neg
IYKAPCENW	cedar_pos
IYLLQYVTL	cedar_neg
IYSKIMDLI	cedar_neg
IYTHNTLSSL	cedar_neg
IYTSSGQLQLF	cedar_neg
IYVNSCLFV	prime_neg
IYVRPFSNF	cedar_neg
KADAKALLHI	cedar_neg
KADAKALLHIL	cedar_neg
KADAKALL	prime_neg
KAEDAHLAQK	prime_neg
KAEDLGMLLK	cedar_neg
KAERSYYIFY	prime_neg
KAFCQFSHL	cedar_neg
KAFELGIPV	prime_neg
KAFIRRGILK	prime_neg
KAFPDYCTYL	cedar_neg
KAFVTPLVLR	prime_neg
KAGECGLK	prime_neg
KAHEAARAL	prime_neg
KAIANRIKFK	prime_neg
KAIESFLEK	cedar_neg
KAIITEDSDL	prime_neg
KALAGLSLL	prime_neg
KALDIMMRV	prime_neg
KALDPHSGHFV	cedar_pos
KALEMGAVK	prime_neg
KAMHKNILK	prime_neg
KANKEILYEAY	prime_neg
KANRNLARK	prime_neg
KAPQVTESIEF	cedar_neg
KAPSDLYQF	cedar_neg
KARKKQQQHRL	prime_neg
KARLPVGAY	cedar_pos
KASLPSKNTPK	prime_neg
KAVCIHCMK	prime_neg
KDSFKKVTLR	prime_neg
KEASSRHFL	cedar_neg
KEIRAIFLF	cedar_neg
KELEGILLL	cedar_neg
KELLKHPFTL	cedar_pos
KENSLIIQF	cedar_pos
KERVELASCCY	prime_neg
KEWEDSQLV	cedar_neg
KEWEDSQLVS	cedar_neg
KEYPVIFKSI	cedar_neg
KFAFQEYDSF	prime_neg
KFARGDYTTTI	cedar_neg
KFGDLTNNF	cedar_neg
KFGHFPVYTL	prime_neg
KFHPQRLQL	cedar_neg
KFHPQRLQLTW	cedar_neg
KFLCRFKQL	cedar_neg
KFLCRFKQLL	cedar_neg
KFLEKVELANF	prime_neg
KFLESCDEVI	cedar_pos
KFLNRNVYIMI	prime_neg
KFQNYSQRR	cedar_neg
KFRSSVYLL	cedar_neg
KFRSSVYLLM	cedar_neg
KGDADVSVPK	cedar_neg
KGLLSDDLLLK	prime_neg
KGTQRILAAL	cedar_neg
KIAAHTRYAL	prime_neg
KIDIERILSV	cedar_neg
KIDLHKYVTV	cedar_neg
KIFIEWLK	prime_neg
KIFMNRCKSLF	prime_neg
KIFNFYPRK	cedar_neg
KIFSEVTLK	cedar_pos
KIGDFGLATEK	prime_neg
KIIAYQPYGK	cedar_neg
KIIEAKTLGK	prime_neg
KIIGSVSKEK	cedar_neg
KIILQAVNFPF	prime_neg
KIINVDDEI	cedar_neg
KIIQEYKKFTK	cedar_neg
KIITYRNIFK	prime_neg
KIITYRNIF	prime_neg
KIKVLASGAF	prime_neg
KILDAVVAQK	cedar_pos
KINDLEVQI	cedar_neg
KINEVKTRK	prime_neg
KINLSLFAL	cedar_neg
KINSRNESHK	prime_neg
KIPCESPPLQV	cedar_neg
KIPRPVLWV	cedar_neg
KIQANALPL	cedar_neg
KIQANALPLML	cedar_neg
KIQTNRNTVK	cedar_neg
KIQVKTLMVK	cedar_neg
KISEGTEFRI	cedar_neg
KITDFGRAK	cedar_pos
KIVEAQSGV	cedar_neg
KIVEAQSGVK	cedar_neg
KIWEELLKI	cedar_neg
KIYAAGTFY	cedar_neg
KIYRRQIFK	cedar_pos
KKKVKGSPSF	cedar_neg
KKRLFRNFGGL	cedar_neg
KKVTLRRYEK	prime_neg
KLAAHLRRK	cedar_neg
KLAARCAAL	prime_neg
KLADYLNVL	cedar_pos
KLAFGQKPPL	cedar_neg
KLANPLPYT	cedar_pos
KLANTVRTRL	prime_neg
KLANTVRTR	prime_neg
KLARHYLIHTV	cedar_neg
KLARVISRLAV	cedar_neg
KLASVTHSVDK	cedar_neg
KLATNLLKEL	cedar_neg
KLCEANQQQQF	cedar_neg
KLCGAAIGEV	prime_neg
KLCIFAPFV	cedar_neg
KLCRTVIAAA	cedar_neg
KLCSKVSFRV	prime_neg
KLCVACPMHSL	cedar_neg
KLDAFFLHML	prime_neg
KLDPRLAQL	cedar_neg
KLDSVCLLK	cedar_neg
KLDTEKMPVV	cedar_neg
KLEAFPLVTEV	cedar_neg
KLESSSPVK	cedar_neg
KLFAIVVGRGI	cedar_neg
KLFAQLINNKA	cedar_neg
KLFEDRVGTIK	prime_neg
KLFEDRVGTI	prime_neg
KLFEFLVYGV	cedar_pos
KLFEHYSQEL	cedar_neg
KLFEQFSKL	prime_neg
KLFESKAELA	cedar_neg
KLFESKAEL	cedar_neg
KLFHDMNVSY	cedar_neg
KLFLEFKIR	prime_neg
KLFSQIYSL	prime_neg
KLFVAGGRL	prime_neg
KLGDSCVTAL	cedar_neg
KLGDVITII	cedar_pos
KLGNRINIIV	cedar_neg
KLGSMQPRHLK	cedar_neg
KLHEAAKLYK	prime_neg
KLHPKAITPR	cedar_neg
KLHRTAWWGK	prime_neg
KLIELTRQV	cedar_neg
KLIFHRHSV	prime_neg
KLIIKFVNDTK	prime_neg
KLIKPNSKDSV	cedar_neg
KLILWRGLK	cedar_pos
KLINECSRPI	cedar_neg
KLIPGVSTT	cedar_neg
KLITKYNLREL	cedar_neg
KLIVELFEEA	prime_neg
KLIVFAQLSV	prime_neg
KLKAIPTTL	cedar_pos
KLKDIREIVPL	cedar_neg
KLKFVTLVF	cedar_pos
KLKLPIIMK	cedar_pos
KLKNGFPHPK	prime_neg
KLKNPKRYQIM	cedar_neg
KLKRFNLSA	cedar_neg
KLLAGVEIV	cedar_pos
KLLDRELKKK	prime_neg
KLLDRELKK	prime_neg
KLLENFYVT	cedar_neg
KLLENFYVTV	cedar_neg
KLLLSEHWAL	prime_neg
KLLMSQANV	cedar_neg
KLLPTNTNI	prime_neg
KLLQALLLQHV	prime_neg
KLLSGEMAIEL	cedar_neg
KLMDGTSQVL	prime_neg
KLMDGTSQV	prime_neg
KLMNIQQKL	cedar_pos
KLMNQAICI	prime_neg
KLMYNVLYYR	prime_neg
KLNFRLFVI	cedar_neg
KLNFRLFVIR	cedar_neg
KLNKYYDWL	prime_neg
KLNTITAVV	cedar_pos
KLPKYGVKV	cedar_pos
KLPLDIDPV	cedar_pos
KLPVGSQCLV	cedar_neg
KLQFHCMPV	cedar_pos
KLQPLSPVV	prime_neg
KLQQLLFSV	prime_neg
KLRRVDFETFL	cedar_neg
KLRSLLHYM	prime_neg
KLRSLLHYMV	prime_neg
KLSEHIRVH	prime_neg
KLSELHTYI	cedar_pos
KLSEQILKK	cedar_neg
KLSHQLVLL	cedar_pos
KLSHQLVLLFL	cedar_pos
KLSPPGTAF	prime_neg
KLSPPGTAFRL	prime_neg
KLSPQQDAGV	cedar_neg
KLSRFSLAR	cedar_neg
KLTLNLQYIV	prime_neg
KLTLWDVFGA	prime_neg
KLTRRPIFI	cedar_neg
KLTRTQAATV	cedar_neg
KLVEHFCPEF	cedar_neg
KLVFGSVFL	cedar_pos
KLVIGRIFYI	prime_neg
KLVRDETPLI	prime_neg
KLVRDETPL	prime_neg
KLVRGATLY	cedar_neg
KLVVVGACGV	cedar_pos
KLVVVGADGV	cedar_pos
KLVVVGAVGV	cedar_pos
KLWASPLHV	cedar_pos
KLWYASLTLV	cedar_neg
KLYALNENI	prime_neg
KLYEEAGDVFL	cedar_neg
KLYEEPLLK	prime_pos
KLYFDEKYSI	prime_neg
KLYGLDWAEL	cedar_pos
KLYLAMISEGY	cedar_neg
KLYQCNECK	cedar_neg
KLYTSEILSPI	cedar_pos
KMAACPKKL	cedar_pos
KMAESLLQV	prime_neg
KMANDIRFL	cedar_neg
KMEKKTCAL	cedar_neg
KMFELTGGL	prime_neg
KMIENESPL	cedar_neg
KMIGFSKTA	cedar_neg
KMIGNHLWV	cedar_pos
KMKNFFFTK	cedar_neg
KMLMKQLSK	prime_neg
KMLSGVGGFV	prime_neg
KMPSKKFGHF	prime_neg
KMPWNNQLL	cedar_neg
KMRPRSIEV	prime_neg
KMTFLFPNL	prime_neg
KMTNFKTTPPV	cedar_neg
KMTVVILQK	prime_neg
KMVAVFYNT	cedar_pos
KMVEAMATGI	cedar_neg
KMWAGKKLA	cedar_neg
KMYHHCPWV	cedar_neg
KNFHFKAVMK	prime_neg
KNIMVRDTR	prime_neg
KNRLVNQPL	cedar_neg
KNRSSGTVSA	cedar_neg
KPASKQLHNEV	cedar_neg
KPDCNPSEAA	prime_neg
KPFCVLISL	cedar_pos
KPFHSLSSF	cedar_neg
KPFHSLSSFRI	cedar_neg
KPFKYDNYSM	prime_neg
KPGNILMDSNM	prime_neg
KPGRAYGLF	prime_neg
KPKKENLWRM	cedar_pos
KPLFPKLAF	cedar_neg
KPLLNCKIYNY	cedar_neg
KPLYLALAQR	prime_neg
KPPKAKPSPTY	cedar_neg
KPRHKNKNRL	cedar_neg
KPRPSEVPE	prime_neg
KPRSAAVEET	prime_neg
KPSDTPRPVM	cedar_pos
KPSILSSLF	prime_neg
KPSLSFYVL	prime_neg
KPSPLAPAA	cedar_neg
KPSPLAPAAL	cedar_neg
KPSSSSRQLDL	prime_neg
KPTENLWLPSM	prime_neg
KPYDAPGAPT	cedar_neg
KQAPGDQVTEI	cedar_neg
KQASSAPFFML	cedar_neg
KQCKLSEHIR	prime_neg
KQCRIYSNAK	prime_neg
KQEAPDALSL	prime_neg
KQFSAMALK	cedar_neg
KQIEHTLNEKI	prime_neg
KQIIHILSK	cedar_neg
KQKVSLLFDHL	cedar_neg
KQPEGLWPPL	cedar_neg
KQQFINQAV	prime_neg
KQSAEGSRK	prime_neg
KQSIHHRWGL	prime_neg
KQSKIVFSV	cedar_neg
KQSQLKGTFK	prime_neg
KQWLVWLAL	cedar_pos
KQWLVWLFL	cedar_pos
KQWSYSTGFPV	cedar_neg
KRFLHRQPL	cedar_neg
KRHEVPVPL	cedar_neg
KRIPLPPHLC	cedar_pos
KRIYTGEKPY	cedar_neg
KRMSVIVRTL	cedar_neg
KRPIPIKYKAM	cedar_pos
KRPTPTFHF	cedar_pos
KRRLLILGR	cedar_neg
KRTNVGILK	cedar_neg
KRVHTGEKPY	prime_neg
KSAVLASNSQF	cedar_neg
KSDIGWIWELW	cedar_pos
KSDKTGWTTF	cedar_neg
KSDKTGWTTFF	cedar_neg
KSEALKLFL	prime_neg
KSFAVWTLA	cedar_neg
KSFGCVECGK	prime_neg
KSFTLNGTK	cedar_neg
KSGTFFVLAY	prime_neg
KSKIPRPVL	cedar_neg
KSLANFGGW	cedar_neg
KSLVAQADK	cedar_neg
KSMAPRQLQPV	cedar_neg
KSMLRNERQFK	cedar_neg
KSPNPSTPC	cedar_pos
KSQREFVRR	prime_pos
KSRCELVEY	prime_neg
KSRDSEHYK	prime_neg
KSSGQGAQLL	prime_neg
KSSGQGAQL	prime_neg
KSSPFTAAA	cedar_neg
KSSSIYSIVK	prime_neg
KSSVSRKNDK	prime_neg
KSYLIQHLR	prime_neg
KSYWNRLQF	cedar_neg
KTASFGIILDV	prime_neg
KTAYYLEVY	prime_neg
KTCRKAFSWK	prime_neg
KTDTSEKRK	prime_neg
KTEESLFRI	prime_neg
KTFEVVPEI	cedar_neg
KTFSLPSLL	cedar_neg
KTFSLPSLLH	cedar_neg
KTGATAGKRK	prime_neg
KTGEQRVVTL	cedar_pos
KTGPGAGPLK	prime_neg
KTIKVSYARPR	prime_neg
KTLAYSFQSL	cedar_neg
KTLAYSFQSLL	cedar_neg
KTLETPEFV	cedar_neg
KTLGPIWK	prime_neg
KTLKINEVK	prime_neg
KTLMVKVMR	cedar_neg
KTLPEMRAY	cedar_neg
KTLQHWPHIVR	cedar_neg
KTLTIPFKNSY	prime_neg
KTLTSVFQKK	prime_pos
KTLTSVFQK	prime_pos
KTMCECMSFY	prime_neg
KTNRIALILA	prime_neg
KTNRIALI	prime_neg
KTNYQCKECGK	prime_neg
KTQGAVAQM	cedar_neg
KTQIKLHLSPK	prime_neg
KTQKLIQQKK	prime_neg
KTQLNPSSR	prime_neg
KTQTMSPRIK	prime_neg
KTSDVNSLV	cedar_neg
KTSDVNSLVGK	cedar_neg
KTSEEIMLV	cedar_neg
KTSQVYLILQV	prime_neg
KTSSGLYVFR	cedar_pos
KTTLVYPATEK	cedar_neg
KTVSITSYI	cedar_neg
KTYIIFFVL	cedar_neg
KTYIIFFVLV	cedar_neg
KTYIIFFVLVI	cedar_neg
KTYPCKIFY	cedar_neg
KTYQVSYGFR	cedar_pos
KVAVATLAK	prime_neg
KVCCCQILL	prime_pos
KVDFTEFLLMV	prime_neg
KVDFTEFLL	prime_neg
KVDIFFLGL	prime_neg
KVDISQGILK	prime_neg
KVDISQGISK	prime_neg
KVDPIGHVY	cedar_pos
KVELANFRFQK	prime_neg
KVFEHVGSR	cedar_pos
KVFKLGNKV	prime_neg
KVFMALLRR	prime_neg
KVFSCSSYL	prime_neg
KVFSCSSYLQA	prime_neg
KVGPWRKAR	prime_neg
KVHSGESRK	cedar_neg
KVIDHVIET	cedar_neg
KVIHGVISSF	prime_neg
KVIHGVISSFV	prime_neg
KVINLSPFK	cedar_neg
KVIQASMFDQK	cedar_neg
KVIQFVANYA	cedar_neg
KVKRIKTLIAK	prime_neg
KVLASGAFGTV	prime_neg
KVLETFLAKCR	prime_neg
KVLGKGSFAK	cedar_neg
KVLSLQTAL	cedar_neg
KVMCRFRPV	cedar_neg
KVMTDPSRK	cedar_neg
KVNYHYLSQVK	prime_neg
KVQDLTPAK	cedar_neg
KVRRSYSRLK	prime_neg
KVSGVILFVV	prime_neg
KVSSVFYTTV	cedar_neg
KVTGHRWLK	cedar_neg
KVTKILFAAL	prime_neg
KVTKILFAA	prime_neg
KVTQSDLSDR	prime_neg
KVVFLFPAV	cedar_neg
KVVGFFFFFL	prime_neg
KVVGFFFFF	prime_neg
KVVVFFFFLL	prime_neg
KVVVFFFFL	prime_neg
KVYEGVWKK	cedar_pos
KWIHCFNDV	cedar_neg
KWLQEPEFQLM	prime_neg
KWLQEPEFQL	prime_neg
KWRLSLCTV	cedar_neg
KWWELLFFI	prime_neg
KYAFITWLV	cedar_neg
KYAFSGVAF	prime_neg
KYALWWYPN	prime_neg
KYARILATK	prime_neg
KYCPVIPLKF	prime_neg
KYCPVIPLK	prime_neg
KYDVWSLGI	prime_neg
KYGDSVCHI	prime_neg
KYINKTIRV	cedar_neg
KYINKTIRVKF	cedar_neg
KYLPVKEIYSW	cedar_neg
KYLQCPLKF	cedar_neg
KYPRKGHVV	cedar_neg
KYQCTATNSF	prime_neg
KYSSGFCNI	cedar_neg
KYVYDFGVSV	cedar_pos
LAARGAACAR	prime_neg
LAAVASLLAAL	prime_neg
LACERLLYL	cedar_neg
LADFRLARLY	cedar_neg
LADLAGFKELF	cedar_neg
LAELLPRLFR	prime_neg
LAENTALYF	cedar_neg
LAFPQARAAL	prime_neg
LAFPQARAA	prime_neg
LAFVIRPTAV	prime_neg
LAGRAGVSNI	prime_neg
LAIGFICAI	prime_pos
LAKELIFRY	cedar_neg
LALAQRKEER	prime_neg
LALAVFSFT	prime_neg
LALPVLASR	prime_neg
LALSIGTSY	cedar_neg
LAMAGSLVF	cedar_neg
LAMAGSLVFL	cedar_pos
LANLENHALF	prime_neg
LANLETLSHSF	cedar_neg
LANTVRTRL	prime_neg
LAPCVRRLL	prime_neg
LAPCVRRLPL	prime_neg
LAQLSDMHLI	prime_neg
LAQLSDMHL	prime_neg
LARAKRPSVF	cedar_neg
LARESSLMTR	prime_neg
LARQTPEPAEL	cedar_neg
LASAGSPTT	prime_neg
LASELKYDM	prime_neg
LASGAFGTVY	prime_neg
LASVLKAKPDF	prime_neg
LASVPSAATF	prime_neg
LASVTHSVDK	cedar_neg
LASWYRIYSK	cedar_neg
LASYFFWGL	cedar_pos
LATSSPMTVK	prime_neg
LAVDNFVRF	prime_neg
LAVFSFTAT	prime_neg
LAVFSPFMM	prime_neg
LAVFYTILTPV	cedar_neg
LAVRWFFAHF	cedar_neg
LAYFLPRPPL	cedar_neg
LAYSFQSLL	cedar_neg
LAYSFQSLLYL	cedar_neg
LDLGKSFHF	cedar_neg
LDYEDGTVTF	prime_neg
LDYEWGTVTF	cedar_pos
LDYGGAPPL	prime_neg
LEAVARNTF	cedar_neg
LEEEINRKM	cedar_neg
LEFENKQAL	cedar_neg
LEFVLGPVS	prime_neg
LEIINALPF	prime_neg
LELKAVHAY	cedar_neg
LEQEKIMLHF	prime_neg
LEREIPLNQPF	cedar_neg
LESAPINTPL	cedar_neg
LESLGAAKPF	prime_neg
LESLSAESY	cedar_neg
LFAALTFFL	prime_neg
LFGASMTGIVY	cedar_neg
LFGVCIYSF	cedar_pos
LFHDMNVSY	cedar_neg
LFHTFYELL	cedar_neg
LFHTFYELLI	cedar_neg
LFLRRRLIF	prime_neg
LFLRRRLIFQK	prime_neg
LFLRVPALPF	prime_neg
LFLSASSNSF	cedar_neg
LFLWMYCPSF	prime_neg
LFPGALYLV	cedar_neg
LFQQGKDLQQY	cedar_neg
LFRIKFKEPL	cedar_pos
LFSSSSFQK	cedar_neg
LFVVFQTVY	cedar_neg
LFYALGIVF	cedar_neg
LFYGGILWCF	prime_neg
LFYLGSSTAF	cedar_neg
LGAEIQHITY	prime_neg
LGDIYNEKRY	prime_neg
LGILGSPSQEY	prime_neg
LGNVWCFPY	cedar_pos
LGPMGGSLTL	cedar_neg
LGRRSLAAR	prime_neg
LGSLHSGTAK	cedar_neg
LGVVESAK	prime_neg
LGYEHWALY	prime_neg
LHAMIQAAGKL	cedar_neg
LHEAQPWFEF	cedar_neg
LHEAQPWFEFL	cedar_neg
LHSDFVSFLI	cedar_neg
LHSEAAYTL	cedar_neg
LIAVSSCILAK	cedar_neg
LIDAVDSTGV	cedar_neg
LIDDYGVEEV	cedar_pos
LIDKTVLIEK	cedar_neg
LIDPSAAKNPK	prime_neg
LIDSNTLQV	cedar_neg
LIDSYSEEV	prime_neg
LIFITPLCDV	prime_neg
LIFNMLYWI	cedar_pos
LIFQKNQQSK	prime_neg
LIFRLSSSSSV	prime_neg
LIFSATLAYFL	cedar_neg
LIIKFVNDTK	prime_neg
LIIPFIHLI	cedar_pos
LIISYVASL	prime_neg
LILILYLLSI	prime_neg
LIMQLMPFGCL	cedar_pos
LINYYISGF	prime_neg
LIQNVRSMK	cedar_neg
LIQRINLKK	cedar_neg
LIRACVSMLR	prime_neg
LISGPSVGV	cedar_neg
LISTYPKAGK	prime_neg
LIVFAQLSV	prime_neg
LIYAVHYFFL	prime_neg
LIYELYVSEL	cedar_neg
LIYTLRNTEVK	prime_neg
LKALAGLSLL	prime_neg
LKALAGLSL	prime_neg
LKHPFTLMY	cedar_neg
LKLRRVDFETF	cedar_neg
LLAAAAIAA	prime_neg
LLAAAAIAAT	prime_neg
LLADQNFKFI	prime_neg
LLAELYCRA	cedar_neg
LLAGTLAVV	cedar_pos
LLAGWRATGA	prime_neg
LLAIGFICA	prime_neg
LLAIKVPNV	cedar_pos
LLAILTYYV	cedar_pos
LLAKREVAL	prime_neg
LLALPVLASR	prime_neg
LLALVLLLLPA	prime_neg
LLALVLLLL	prime_neg
LLAMTVPNV	cedar_pos
LLARFATSAL	cedar_neg
LLASYDEISV	cedar_neg
LLATSSPMTVK	prime_neg
LLAVLTAPPV	prime_neg
LLAVRWFFAHF	cedar_neg
LLAVVDLIV	prime_neg
LLAWMIPNV	prime_neg
LLCADPGFV	prime_neg
LLCRRSRAAL	cedar_neg
LLCSSCWDF	cedar_neg
LLDAVYLFCL	prime_neg
LLDDECAFYT	cedar_neg
LLDDQILQL	cedar_neg
LLDEKGPEV	cedar_pos
LLDGGLPAG	prime_neg
LLDIADFFQV	prime_neg
LLDIDRFTI	cedar_neg
LLDIWDGIPHV	cedar_neg
LLDLMAYDRY	prime_neg
LLDNSTTGTDV	cedar_neg
LLDSLPMDV	cedar_neg
LLEEFSWTQY	prime_neg
LLEPHQVGL	cedar_neg
LLFAAFSSA	cedar_pos
LLFALHFSA	cedar_pos
LLFAPEYGPK	cedar_neg
LLFFLATFNK	prime_neg
LLFFSVWIKL	prime_neg
LLFGMPPCL	cedar_pos
LLFGMPPCLL	cedar_pos
LLFGSGLPSA	prime_neg
LLFGYSFAT	cedar_pos
LLFILVVSFL	prime_neg
LLFLGAGLFL	prime_neg
LLFLTIFIYA	cedar_pos
LLFQRFFVI	cedar_neg
LLFSETGFL	prime_neg
LLFSLFFLI	cedar_neg
LLFTLSYPYDK	prime_neg
LLFTLSYPY	prime_neg
LLGCVMYTLL	cedar_pos
LLGCVMYTL	prime_neg
LLGDPGWRV	prime_neg
LLGGNSFEV	cedar_neg
LLGGWFQSSL	cedar_neg
LLGPNSFEV	cedar_pos
LLGRNSFEM	prime_neg
LLGRRSLAAR	prime_neg
LLGSAQALPV	prime_neg
LLGSSCAPPL	cedar_neg
LLGSVNNLL	cedar_neg
LLGVKLFGV	prime_neg
LLHASFVTL	cedar_pos
LLHASFVTLGK	cedar_pos
LLHGFSFYL	cedar_pos
LLHMCQPDL	prime_neg
LLHTELERF	cedar_neg
LLHTELERFL	cedar_neg
LLIASVTWL	cedar_pos
LLIASVTWLL	prime_neg
LLIGFLSGSL	cedar_neg
LLIKLSSPAV	prime_neg
LLINRGFSK	cedar_neg
LLIQKFTDV	cedar_neg
LLIYCQAGV	prime_neg
LLKAELVAGL	cedar_pos
LLKDCIFDL	prime_neg
LLKEVYQSEHL	cedar_neg
LLKHIFSTG	cedar_neg
LLKHPFTLM	cedar_pos
LLKYKIKDY	cedar_neg
LLLAELSSPFV	cedar_neg
LLLAGVPAA	prime_neg
LLLASTSGA	cedar_pos
LLLAVTSWV	prime_neg
LLLCGVQAV	cedar_neg
LLLDIVAPK	prime_pos
LLLEEQLYNK	prime_neg
LLLEFGANM	cedar_neg
LLLEVDLRY	prime_neg
LLLEVVWHL	cedar_neg
LLLFFSVWI	prime_neg
LLLFLTIFI	cedar_pos
LLLIASVTWL	prime_neg
LLLLFDAFGL	prime_neg
LLLNAGSTV	cedar_neg
LLLNMLIVL	cedar_pos
LLLPAPPAGL	prime_neg
LLLPHYASAK	cedar_neg
LLLQLTTPA	cedar_neg
LLLQVLFWLI	prime_neg
LLLQVLFWL	prime_neg
LLLSARFYA	prime_neg
LLLSEHWAL	prime_neg
LLLSISLLI	prime_neg
LLLSPSLQV	prime_neg
LLMGSSDLA	cedar_neg
LLMLLIGFL	cedar_neg
LLMLLIPLSV	prime_neg
LLMNIEVVEV	prime_neg
LLMPSLENL	prime_neg
LLMSQANV	prime_neg
LLMVSITLL	cedar_neg
LLNAASLLSV	prime_neg
LLNYFQNSHSV	cedar_neg
LLPACYQHF	prime_neg
LLPALSPGL	cedar_neg
LLPHYASAK	cedar_neg
LLPPVYLTF	cedar_neg
LLPVLSWLL	cedar_neg
LLQALLLQHVL	prime_neg
LLQALLLQHV	prime_neg
LLQAYRLISV	prime_neg
LLQDGDIQV	cedar_neg
LLQEEAHVPL	cedar_neg
LLQICERIPTI	cedar_neg
LLQVYCEMYGL	cedar_neg
LLRCSKECLK	prime_neg
LLRKHQLIYL	cedar_neg
LLRPTLDQSTM	cedar_neg
LLRVHTEHV	prime_neg
LLSAPPCTQHI	cedar_neg
LLSATIFLV	prime_neg
LLSCSADGAV	cedar_neg
LLSDDLLLK	prime_neg
LLSECVHAL	prime_neg
LLSESMVEYK	prime_neg
LLSIDLFYV	prime_neg
LLSIIFFPA	cedar_pos
LLSIVPCTV	cedar_neg
LLSPDLIRNEV	cedar_neg
LLSPLGAEICL	prime_neg
LLSPLGAEI	prime_neg
LLTKDSYKV	cedar_neg
LLTKEDDCSEV	prime_neg
LLTQLRAEV	cedar_neg
LLTTIYFFLI	prime_neg
LLTTIYFFL	prime_neg
LLTWQQLEK	prime_neg
LLVAAEPYL	prime_neg
LLVAAMIGGFV	cedar_neg
LLVALLDGGL	prime_neg
LLVDAMHNQL	cedar_pos
LLVDLAEEL	cedar_pos
LLVEKTTCV	cedar_neg
LLVLCQQPVI	prime_neg
LLVLCQQPV	prime_neg
LLVLWAFCV	prime_neg
LLVRNSFEV	cedar_neg
LLVVKFCNV	prime_neg
LLWEIFFLGA	prime_neg
LLWMNLFVGF	cedar_neg
LLYKLSSFEK	prime_neg
LLYNDQPPR	cedar_neg
LLYNLGLVEA	prime_neg
LLYPHSLSS	cedar_neg
LLYPHSLSSK	cedar_neg
LLYPHSLSSKL	cedar_neg
LLYQELLPL	cedar_pos
LLYRLLQGSI	prime_neg
LLYRLLQGS	prime_neg
LMANTISFNA	prime_neg
LMASISSFL	cedar_pos
LMASISSFLL	cedar_pos
LMASISSFLLV	cedar_pos
LMASKTDDPGI	prime_neg
LMAVAILKEV	cedar_neg
LMAVRSKYSEV	cedar_neg
LMCGTWYKVK	prime_neg
LMDDSLMQIF	prime_neg
LMDSNMHVK	prime_neg
LMFAIFFLT	prime_neg
LMFWASSSI	cedar_pos
LMGTEQLFTEL	cedar_neg
LMILSANWAY	cedar_neg
LMILSANWAYV	cedar_neg
LMLEISTSL	cedar_neg
LMLEYQKILWK	cedar_pos
LMMEHPSLQAI	cedar_neg
LMMNPLIYSL	prime_neg
LMMNPLIYS	prime_neg
LMMPFSIVYI	cedar_pos
LMMSLSALF	cedar_neg
LMRDHMPPV	cedar_pos
LMRVMDISYL	cedar_neg
LMSALRLAACK	prime_neg
LMSQVVVAGL	prime_neg
LMTDTQFVLAV	cedar_neg
LMTDTQFVL	cedar_neg
LMTLHGFMMY	cedar_pos
LMTRETWEV	prime_neg
LMVISMACV	prime_neg
LMVPHSPSL	cedar_pos
LMVPQPCPG	prime_neg
LMVPQPCPGSL	prime_neg
LMYACCLLML	prime_neg
LNLALAVFSF	prime_neg
LNLPPDPEM	prime_neg
LNRSSSQGTQL	cedar_neg
LNSGVGFQVY	prime_neg
LPACYQHFM	prime_neg
LPADIVPIL	prime_neg
LPAEGVSEV	cedar_neg
LPAIMFFVSA	cedar_neg
LPALAFTFFSL	cedar_pos
LPALKIWEEL	cedar_neg
LPALSQCSQL	cedar_neg
LPALVAEAW	prime_neg
LPAPGGGES	cedar_neg
LPAPPDGPEV	prime_neg
LPAPQQYIV	cedar_neg
LPATGWTKS	cedar_neg
LPATGWTKSM	cedar_neg
LPDYAEVLL	prime_neg
LPEMRAYQDKW	cedar_neg
LPEPDKMLVAV	cedar_neg
LPFCGPREPSL	prime_neg
LPFSPEFSEFF	cedar_neg
LPGEKGHPGL	cedar_neg
LPGFSGLRGI	cedar_neg
LPGLPGNGL	cedar_neg
LPGLPGNGLPG	cedar_neg
LPILGEQVV	cedar_neg
LPIQYEPVL	cedar_neg
LPLLKASFQPF	prime_neg
LPLLYKLSSF	prime_neg
LPMETPLVI	cedar_neg
LPMGLSLSA	prime_neg
LPMGLSLSAS	prime_neg
LPNEYAFVT	cedar_pos
LPNEYAFVTT	cedar_pos
LPNISWELGL	prime_neg
LPPEMTVARSL	cedar_neg
LPPGSLIAPM	prime_neg
LPPQRLMIL	prime_neg
LPQGWKMNSTL	cedar_neg
LPQQFHLKIL	cedar_neg
LPQSIDRLISL	prime_neg
LPRAKKLIL	cedar_pos
LPRQIHVSS	prime_neg
LPRQIHVSSV	prime_neg
LPSFRPPTAL	cedar_neg
LPSWGASQQAL	cedar_neg
LPTLPTREPK	cedar_neg
LPTRKDPHAL	prime_neg
LPTVKLAEV	cedar_neg
LPTVSTPPPF	prime_neg
LPVAAAFIE	prime_neg
LPVAAAFIET	prime_neg
LPVGSQCLV	cedar_neg
LPVGSQCLVDL	cedar_neg
LPVTDTSSV	prime_neg
LPVTDTSSVS	prime_neg
LPVTRKNMPL	cedar_neg
LPWLSAHEL	cedar_neg
LPYGLPTGL	prime_neg
LQAEHRLLK	prime_neg
LQALGPEAPA	prime_neg
LQALLLQHVL	prime_neg
LQALLLQHV	prime_neg
LQALVGNPI	prime_neg
LQDFYMHLKV	prime_neg
LQEEAHVPL	cedar_neg
LQEEAHVPLQF	cedar_neg
LQFARAHALM	prime_neg
LQFARAHAL	prime_neg
LQFEYTFEI	cedar_neg
LQFLTPLGEY	prime_neg
LQGKPARPL	prime_neg
LQGPILRLHY	prime_neg
LQGSILAYL	prime_pos
LQGVERIMNK	prime_neg
LQHDKLVRV	cedar_neg
LQINCSHFSTI	cedar_neg
LQKGRSFNL	prime_neg
LQKGRSFNLTA	prime_neg
LQLERINVYH	prime_neg
LQLERINVY	prime_neg
LQLYRVLQCA	prime_neg
LQNASFVLY	prime_neg
LQQPEASVL	prime_neg
LQQPEASVLY	prime_neg
LQQYKTLAYSF	cedar_neg
LQREQQHLK	cedar_neg
LQRIHHMAA	cedar_neg
LQRMSGCDV	prime_neg
LQTIKDIASPI	cedar_pos
LQVEVEYYTLF	prime_neg
LQVEVEYYTL	prime_neg
LQVKWSTASK	prime_neg
LQWEELDWQKY	prime_neg
LRAAFFGKCF	cedar_pos
LRDGQILEF	prime_neg
LRFNLIANQH	cedar_neg
LRFSIIEEF	cedar_neg
LRFWCPFGFI	prime_neg
LRFWCPFGF	prime_neg
LRHVALGLFL	prime_neg
LRILKVTEFK	cedar_pos
LRILRIKLR	cedar_neg
LRLLLEEQLY	prime_neg
LRLNHPAQL	cedar_neg
LRLPDYAEVL	prime_neg
LRMRGTIFR	cedar_neg
LRNQKGFVRL	prime_neg
LRNSGGEVF	cedar_neg
LRTKVYAEL	cedar_pos
LRVPALPFLL	prime_neg
LRVPALPFL	prime_neg
LSAIRTVAK	prime_neg
LSAKTCNVDY	prime_neg
LSAQSHCSTY	cedar_neg
LSASRRKQQF	prime_neg
LSDMENHGA	prime_neg
LSDSRPRHL	cedar_neg
LSEECYWSL	cedar_neg
LSESMVEYK	prime_neg
LSFFTVMAY	prime_neg
LSFTCPSVK	prime_neg
LSGEWFTFYL	cedar_neg
LSGEWFTFYLV	cedar_neg
LSHSFNWRK	cedar_neg
LSIGTSYRY	cedar_neg
LSLCRMTGMK	prime_neg
LSLLKIRNRL	prime_neg
LSLSLRPSAR	prime_neg
LSPLSWVSV	cedar_neg
LSQCSQLTTFY	cedar_neg
LSQGVTLVVDK	prime_neg
LSSDESGNLTF	prime_neg
LSSDGKPFK	prime_neg
LSSFRIHER	cedar_neg
LSSSGAPSLK	cedar_neg
LSSSSSVRATL	prime_neg
LSSSSTLTL	cedar_neg
LSSSVPRK	prime_neg
LSVEFSEMM	cedar_neg
LSVTHMTSR	cedar_neg
LSWGRPGAR	prime_neg
LSWYDRGVPF	prime_neg
LSYCLPPTF	cedar_neg
LSYNSHYSR	prime_neg
LSYPYDKTGK	prime_neg
LSYPYGSKSDK	prime_neg
LSYTWNIPV	cedar_neg
LTATTQAPM	cedar_neg
LTCEPTVPY	prime_neg
LTDDRLFTCY	prime_pos
LTDTSLTAL	prime_neg
LTEKVSLLK	cedar_neg
LTELKNFANY	prime_neg
LTERANFQY	prime_neg
LTFLERPREK	cedar_neg
LTFNQCYGV	cedar_pos
LTFPMTALPL	prime_neg
LTGLPHAPAL	prime_neg
LTGNESFALPY	cedar_neg
LTHEVIVPL	cedar_neg
LTHKQELQAVK	cedar_neg
LTHNAVCPI	cedar_neg
LTIEDLGTL	prime_neg
LTIPFKNSYK	prime_neg
LTKEDDCSEVL	prime_neg
LTLFWAPPER	cedar_neg
LTLIHTLEEK	prime_neg
LTLSGFFLR	cedar_neg
LTMSGRGSNY	prime_neg
LTNGVINAEF	prime_neg
LTNWRFTRGV	prime_neg
LTPKWSEKYSK	cedar_neg
LTPNLQGFY	prime_neg
LTQEALSIY	prime_neg
LTQHEMIFK	prime_neg
LTQHEMIFKR	prime_neg
LTSLSGIAHK	cedar_neg
LTSMAYDCY	prime_neg
LTSTVQLIM	cedar_pos
LTVETLTKV	cedar_neg
LTWETDNIFVI	prime_neg
LTWETDNIFV	prime_neg
LVAAEPYLY	prime_neg
LVACRGTEL	prime_neg
LVAEAWRGGAK	prime_neg
LVAKLANTVR	prime_neg
LVALAFVIR	prime_neg
LVALAWMHVL	prime_neg
LVANFSQIK	prime_neg
LVEQALRFY	prime_neg
LVESFSEKY	prime_neg
LVFEDCDEV	prime_neg
LVFGCVFWLI	prime_neg
LVFGCVFWL	prime_neg
LVFPLVMGV	cedar_pos
LVFVGMNLTR	prime_neg
LVFVNDKIF	prime_neg
LVGPAQLSHW	cedar_neg
LVHDETPHL	prime_neg
LVIGMPPPV	cedar_pos
LVIGRIFYI	prime_neg
LVKFLEFER	prime_neg
LVKFPEMFQK	prime_neg
LVLFEDAVAY	cedar_pos
LVLLCLFFR	prime_neg
LVLLFLRDPYV	cedar_neg
LVLLVLCQQPV	prime_neg
LVLSVVLPEK	prime_neg
LVNSLSLEF	cedar_neg
LVPIYIIYK	prime_neg
LVRDRWQKV	cedar_neg
LVRDRWQKVLV	cedar_neg
LVRGATLYI	cedar_neg
LVRGVRLSF	cedar_neg
LVRLGIQTF	cedar_neg
LVRRSRTYSL	cedar_neg
LVRRTLLHV	cedar_pos
LVSDILSCK	prime_neg
LVTKGEHMTEK	cedar_neg
LVTYSGKFLIL	cedar_neg
LVVLAPLLY	prime_neg
LVVVGASGVGK	cedar_neg
LVWLFLGHMV	prime_neg
LVWLLLGPM	prime_neg
LVWLLLGPMV	prime_neg
LVYGPLGAGK	cedar_neg
LWCRQPPYR	prime_neg
LWMNLFVGF	cedar_neg
LWMNLFVGFRF	cedar_neg
LWPHLGPPPL	prime_neg
LWTEMITNI	cedar_neg
LYCVLIESL	cedar_neg
LYDFLDYYY	prime_neg
LYFIPYMFL	prime_neg
LYIVDGMAQLM	cedar_neg
LYIWFKTACL	cedar_pos
LYLDYQIQATV	cedar_neg
LYLEGGLLF	prime_neg
LYMPKVYITIF	prime_neg
LYMPKVYITI	prime_neg
LYMTGFFGGYI	prime_neg
LYNAGLFLW	cedar_neg
LYNGMEHLI	cedar_pos
LYNNPVTAVFK	prime_neg
LYPEFIASI	cedar_pos
LYQFILKAL	cedar_neg
LYQIQALRW	prime_neg
LYQRWEAQNKV	cedar_neg
LYTSEILSPI	cedar_neg
LYWHVSHDF	cedar_neg
LYYEYWSNF	cedar_neg
MAASLPPTL	cedar_neg
MAEGIFHSPGY	cedar_neg
MAFDRYVAICF	prime_neg
MAGPKGFQY	cedar_neg
MAGSLVFLSSL	cedar_neg
MAHVSVVPVF	cedar_neg
MAKTSTSLPY	cedar_neg
MALSLLPPR	prime_neg
MALTASTVPL	cedar_neg
MASGDHSAY	cedar_neg
MASILKGYRLY	cedar_neg
MASISSFLL	cedar_neg
MASISSFLLV	cedar_neg
MASISSFLLVR	cedar_neg
MASMSGRWKR	cedar_neg
MASMSGRWKRK	cedar_neg
MAVGISHLK	cedar_neg
MAVKKSAIF	prime_neg
MEAIRLYQF	cedar_pos
MEAVALVGAW	cedar_neg
MEAVALVGAWY	cedar_neg
MELKVESF	prime_neg
MEMNGDEIAI	prime_neg
MESDLELKKY	prime_neg
METLHIIYLEA	cedar_pos
MFHGGINFGY	prime_neg
MFYKILHSFK	prime_neg
MFYKILHSF	prime_neg
MGFFRRSVIK	cedar_neg
MGMMGPPGPL	prime_neg
MGMNSIEPAK	cedar_neg
MGMSMAQSSY	prime_neg
MGNKIDLEQF	prime_neg
MHENFTNLL	cedar_neg
MIACNIREL	prime_neg
MIISHLYLI	cedar_pos
MILGWKFFY	prime_neg
MILTGILLIEI	cedar_pos
MIMLGDKKKTF	cedar_neg
MIQQSRAPL	prime_neg
MISPNSFFH	cedar_neg
MIWNVQKIF	prime_neg
MIYGYDTWI	cedar_neg
MLAEKTVQV	cedar_neg
MLAEQLKQA	cedar_neg
MLAVFKLYPT	prime_neg
MLAVISCAV	cedar_neg
MLCAENPEV	prime_neg
MLDLGLAAFL	prime_neg
MLDLGLAAF	prime_neg
MLDQELAKF	prime_neg
MLEYQKILWK	cedar_pos
MLEYQKILWKV	cedar_pos
MLFARGLLGI	prime_neg
MLFLRFCYI	prime_neg
MLGEQLFPL	cedar_pos
MLIGIPVYV	cedar_pos
MLIVETAVML	prime_neg
MLIVETAVM	prime_neg
MLKAKSQFK	cedar_neg
MLKSRCELV	prime_neg
MLLENKAVEKA	cedar_pos
MLLENKAVEK	cedar_pos
MLLENVLKPL	cedar_neg
MLLIGFLSGSL	cedar_neg
MLLKHDVSL	cedar_pos
MLLLGLLHA	cedar_neg
MLLLLLLLLL	prime_neg
MLLLLLLLL	prime_neg
MLLLMEREDKV	cedar_neg
MLLQAYRSV	cedar_neg
MLLQTCQDF	cedar_neg
MLMKNISTK	cedar_neg
MLMLAVIVA	cedar_pos
MLNPLIYSFR	prime_neg
MLQIINIVL	cedar_neg
MLQQQPSPPV	cedar_neg
MLQWEELDWQK	prime_neg
MLQYKKKAAV	cedar_neg
MLREEIAML	cedar_neg
MLRLTSGRKAL	prime_neg
MLSGVGGFVL	prime_neg
MLSGVGGFV	prime_neg
MLSILALVRV	cedar_pos
MLSPLEDEL	prime_neg
MLSSNVINF	cedar_neg
MLTRYARAQFV	cedar_neg
MLTSEIVPAL	prime_neg
MLVLTFRDVAV	cedar_neg
MLVRRTEGI	cedar_neg
MLWGSLTQL	prime_neg
MLYVVPWPGKA	prime_neg
MLYVVPWPG	prime_neg
MMDYPYPTNFL	cedar_pos
MMFPAQPFGL	cedar_neg
MMLLLLLLLL	prime_neg
MMLLLLLLL	prime_neg
MMMWDCWHA	cedar_pos
MMMWDCWHAV	cedar_pos
MMNPLIYSL	prime_neg
MMPFSIVYI	cedar_pos
MMPFSIVYIV	cedar_pos
MMPPLPGI	prime_neg
MMSLSALFNI	prime_neg
MMWDCWHAV	cedar_pos
MNDGLLRLSR	prime_neg
MNLFVGFRF	cedar_neg
MNLILAVVAM	prime_neg
MNLRPILTI	cedar_neg
MNLRPILTII	cedar_neg
MPAAEEMRKNV	cedar_neg
MPAALNPLV	prime_neg
MPAAVLKPS	prime_neg
MPEPGIYHGI	prime_neg
MPFTTVSELM	cedar_neg
MPGRSSSNSA	cedar_neg
MPHQKATTAH	prime_neg
MPIEPGDIGC	cedar_pos
MPKVYITIFH	prime_neg
MPLAPTRSNL	prime_neg
MPLAPTRSNLW	prime_neg
MPLVILIVL	cedar_pos
MPLVILIVLVL	cedar_pos
MPSHCNTQY	cedar_neg
MPSKKFGHF	prime_neg
MPSKKFGHFPV	prime_neg
MPSVFTLVGI	prime_neg
MQAFAQVFSK	cedar_neg
MQANSHYARV	prime_neg
MQLKVHKEK	prime_neg
MQLLFDNEV	cedar_neg
MQLMPFGCL	cedar_neg
MQLMPFGCLL	cedar_pos
MQLMPFGSLL	cedar_pos
MQRHYVMCY	prime_neg
MQYGDPTEYY	prime_neg
MRMNQGVCC	cedar_pos
MRRASSSSSL	prime_neg
MRRASSYSPL	prime_neg
MRRTRPSAA	cedar_neg
MRYFYTAVSR	prime_neg
MSFYLREQGK	prime_neg
MSHNTEMNNY	prime_neg
MSQPDAQRY	cedar_neg
MSSYIASFTY	prime_neg
MTDTQFVLAV	cedar_neg
MTEHHAGRY	cedar_neg
MTEMPNHLH	prime_neg
MTFLGGNLVK	prime_neg
MTFSDVLTL	cedar_neg
MTFSSTKDYV	cedar_neg
MTGMKEMLRK	prime_neg
MTGMKEMLR	prime_neg
MTGPRGLDQLR	cedar_neg
MTLHGFMMY	cedar_pos
MTLKEYHYV	cedar_neg
MTLTFEKPIK	prime_neg
MTLTFQDVAVY	prime_neg
MTSLHLTTR	cedar_neg
MTSPHFIEFV	cedar_neg
MTVARSLVK	cedar_neg
MTVSLVVKM	prime_neg
MVDTRGGSM	cedar_neg
MVGPEAGRTK	prime_neg
MVISYVVYY	prime_neg
MVLAELYVSER	cedar_neg
MVLFTTMAFDR	prime_neg
MVLVPIYIIY	prime_neg
MVRDTRCVY	prime_neg
MVSSNENCRK	prime_neg
MVVHEIQNY	cedar_neg
MVYWTGGIPA	cedar_neg
MWKCQNMIR	prime_neg
MWMTLTFFV	cedar_neg
MYCPSFNSAI	prime_neg
MYGAHLPSI	prime_neg
MYSNADIYL	cedar_neg
MYSNADIYLF	cedar_neg
MYSNADIYLFD	cedar_neg
MYSRAQVEL	cedar_neg
MYSRAQVELNL	cedar_neg
NAAPVDLTL	prime_neg
NACLFTIMK	prime_neg
NAELIDQSF	prime_neg
NAFSGEYIPTV	cedar_pos
NAGETLLQRV	prime_neg
NEKIILQAVNF	prime_neg
NERDVQSSS	prime_neg
NETPVAVLTI	cedar_neg
NEVSEVTVF	cedar_neg
NEYAFVTTF	cedar_neg
NFFKTSAQVVL	cedar_neg
NFLNNSGIL	cedar_neg
NGTSSLIIYK	cedar_neg
NHARIDAAKV	cedar_neg
NHDETSFLL	cedar_neg
NIDATTTETY	prime_neg
NIFKKVYLL	prime_neg
NIHTGEMPFK	prime_neg
NIKQHQDEEK	prime_neg
NILMDSNMHVK	prime_neg
NISAFKCDSK	prime_neg
NISEDVIFF	cedar_pos
NISSGTRML	cedar_neg
NIYVDALFK	cedar_neg
NLALAVFSF	prime_neg
NLARFCWYL	prime_neg
NLDEKANEI	cedar_neg
NLFNRYLAL	cedar_pos
NLFSFHLATL	prime_neg
NLGENKHYDV	cedar_neg
NLGNREAEL	cedar_neg
NLIFVFYML	cedar_neg
NLIFVFYM	prime_neg
NLINYYISGF	prime_neg
NLKRVVEDSEY	cedar_neg
NLLGGNSFEVR	cedar_neg
NLLGRNSFEM	prime_neg
NLLNHSWLV	cedar_neg
NLLNYPDHYV	prime_neg
NLLRILYKL	prime_neg
NLNCCSVPV	cedar_pos
NLNKHRRYK	cedar_neg
NLNPNVDPQV	cedar_neg
NLQDFYMHLKV	prime_neg
NLQDFYMHL	prime_neg
NLQERIDYCHL	cedar_neg
NLQNQMSSL	cedar_neg
NLQREEYTV	cedar_pos
NLRRSKKRAL	prime_neg
NLRYFAKSL	cedar_pos
NLSEVFYQVGK	prime_neg
NLSPALGQMPL	cedar_neg
NLTEGPYPL	cedar_neg
NLVFEDCDEV	prime_neg
NLWIPSSSLAK	cedar_neg
NLWLPSMPQK	prime_neg
NLYRVYFPV	prime_neg
NMAAGNNPNI	prime_neg
NMALETAASV	prime_neg
NMWCCSFDR	prime_neg
NNFAEMHAY	prime_neg
NPALCVQPHY	cedar_neg
NPDSVNASL	prime_neg
NPDVNITNLEF	cedar_neg
NPEAIAEVV	cedar_neg
NPFELSFSL	prime_neg
NPHYHENAGI	cedar_neg
NPKSDELKL	cedar_neg
NPLECTWVEL	prime_neg
NPLMCRLLGI	cedar_neg
NPLNGASAEL	prime_neg
NPLSEADVRVL	prime_neg
NPLVNSLSL	cedar_neg
NPLVNSLSLEF	cedar_neg
NPMWNELFL	prime_neg
NPNKTQDAGKY	prime_neg
NPRRAYVTPP	prime_neg
NPSRRQLIY	prime_neg
NPVGLQNASF	prime_neg
NPVTAVFKY	prime_neg
NQLIYELYV	cedar_neg
NQMAGLGPRF	prime_neg
NQMAGLGPR	prime_neg
NRENREQYQL	prime_neg
NREQYQLVI	prime_neg
NRHDCWSLISL	cedar_pos
NSADNVPLK	prime_neg
NSDLSPYLCH	prime_neg
NSGGYPPLCY	prime_neg
NSGVGFQVY	prime_neg
NSGVGFQVYV	prime_neg
NSIMYFTEK	prime_neg
NSKKKWFLF	cedar_neg
NSLIQRINLKK	cedar_neg
NSSDRRKHM	prime_neg
NSTLSGEWFTF	cedar_neg
NSYKYSSMIDY	prime_neg
NTATNLPSV	cedar_neg
NTDEPEDFISK	prime_neg
NTHSDGAILPF	cedar_neg
NTLEQTVPY	prime_neg
NTLPNYQSF	cedar_neg
NTPFLFSLY	prime_neg
NTPNVHRTK	prime_pos
NTQTSDTLSK	prime_neg
NTRRKFFIY	prime_neg
NTSRYATAL	cedar_neg
NTVILETLK	cedar_pos
NVDMRTISF	cedar_neg
NVDQKVIQASM	cedar_neg
NVELRRNVL	cedar_neg
NVHRTKRTR	prime_neg
NVIEFLAPLK	prime_neg
NVLEWIIYA	cedar_neg
NVLSSLVLV	cedar_neg
NVNADSVVY	prime_neg
NVNADSVVYY	prime_neg
NVYEVVNSK	cedar_neg
NVYEVVNSKK	cedar_neg
NVYEVVNSKKK	cedar_neg
NWPTRVCADV	cedar_neg
NYICNSSCM	cedar_neg
NYIPSNDLRAF	cedar_neg
NYKQYIPLSI	prime_neg
NYMISPNSFF	cedar_neg
NYNENTGEKL	cedar_neg
NYQSFSSTSAL	cedar_neg
NYVAGGQEV	cedar_neg
NYVAGGQEVF	cedar_neg
NYVNDFLARL	prime_neg
NYWWRGQTL	cedar_neg
PALSRSALV	prime_neg
PAQSSVTFK	prime_neg
PCLPPTPCPL	prime_neg
PEGYHDPNCL	prime_neg
PFFSIFPKCF	cedar_neg
PFLDLGKSFHF	cedar_neg
PFSQCTKSF	cedar_neg
PILENPFFSI	cedar_neg
PILENPFFSIF	cedar_neg
PIYIPSRLCK	cedar_neg
PLFSSSSGV	cedar_neg
PLIDVNWCA	cedar_neg
PLLEAIDPDV	cedar_neg
PLLPALSPGL	cedar_neg
PLMGISHQEEV	cedar_neg
PLNGWMYWK	prime_neg
PLYLALAQRK	prime_neg
PLYRFSLLNK	cedar_neg
PMWNELFLF	prime_neg
PPAAAAPAV	prime_neg
PPAGGCRSPL	prime_neg
PPAGGPSPAHL	prime_neg
PPAPPTQPL	prime_neg
PPEMTVARSL	cedar_neg
PPGTRVRVM	prime_neg
PPNFLNNSGIL	cedar_neg
PPPPATTPF	prime_neg
PPPSRPISPA	cedar_neg
PPQCPPQSPL	prime_neg
PPRGFSPYL	cedar_neg
PPSAEYESL	cedar_neg
PPSAEYESLV	cedar_neg
PPSLLWMNL	cedar_neg
PPSPAGAPGPA	cedar_neg
PPSRPISPA	cedar_neg
PPTSPVQTPL	cedar_neg
PPVLSGLVRVL	prime_neg
PRQDLGTLKI	prime_neg
PSCYWFGNCR	prime_neg
PSDTRQMLF	prime_neg
PSDTRQMLFY	cedar_pos
PSLLWMNLFV	cedar_pos
PSMGTPPPL	prime_neg
PSSAKAGLCY	prime_neg
PSSFGLHLFK	prime_neg
PTATPAYPGV	prime_neg
PVMYQGNTY	prime_neg
PWLSSGILCLF	prime_neg
PWWNFGSLL	cedar_pos
PYAEHYLMPF	prime_neg
PYALVRLGI	cedar_neg
PYISGPLRF	cedar_neg
PYLNWTIER	prime_neg
PYMFLSEWI	cedar_pos
PYTRDQIMTI	cedar_neg
PYTRDQIMTIL	cedar_neg
QAAKGNYGLLY	prime_neg
QAIGKLPIAM	prime_neg
QALADLAGFK	cedar_neg
QALRFYDYK	prime_neg
QASGNHHVW	cedar_neg
QATEAERSF	cedar_pos
QAVAAVQKL	cedar_neg
QCEEVARVL	cedar_pos
QDVSVQVER	cedar_pos
QDYDRARHYL	prime_neg
QEECLWMAV	cedar_pos
QEFAPLGTV	cedar_neg
QEIQILKAL	cedar_neg
QELAACQLLI	prime_neg
QELAACQLL	prime_neg
QESAFSHSAF	prime_neg
QESFAVVQDW	prime_neg
QETYTKVMNW	prime_neg
QFARAHALMF	prime_neg
QFAVGSYVY	cedar_neg
QFFFFFFFFF	prime_neg
QFFFFFFFF	prime_neg
QFHLKILFL	cedar_neg
QFHLKILFLPL	cedar_neg
QFMGVIMFI	cedar_neg
QFVLAVKRTVF	cedar_neg
QGCHAAVEAM	prime_neg
QHEMIFKRL	prime_neg
QHQPNPFEV	cedar_pos
QHSIRAKQIL	prime_neg
QHSIRAKQI	prime_neg
QHTPLPVTSL	prime_neg
QICERIPTI	cedar_neg
QIDEPVSPSEV	cedar_neg
QIHERTHTGKK	prime_neg
QIHERTHTGK	prime_neg
QIIHTYSNTV	cedar_pos
QIKLHLSPK	cedar_neg
QILGCFLVSK	prime_neg
QIMTILANMSV	cedar_neg
QINITAVAHV	cedar_neg
QKKPFEEYWR	prime_neg
QKRPIPIKYKAM	cedar_pos
QKSDENQYL	prime_neg
QKTYQVSYGFR	cedar_pos
QLALSIGTSY	cedar_neg
QLANGAFKV	cedar_neg
QLCDVMFYL	cedar_pos
QLDIIPASV	cedar_pos
QLDKCSAFV	cedar_neg
QLFARARPM	cedar_neg
QLFEDAYLL	prime_neg
QLFNCQALQK	prime_neg
QLFSLPPVLR	cedar_neg
QLFYALGIV	cedar_neg
QLFYALGIVF	cedar_neg
QLIMQLMPF	cedar_neg
QLIMTFFQV	cedar_neg
QLIPRLFFA	cedar_neg
QLIYELYVSEL	cedar_neg
QLKLIPPGLF	prime_neg
QLLAAAAIAA	prime_neg
QLLAKLTGV	prime_neg
QLLAVVDLI	prime_neg
QLLAVVDLIV	prime_neg
QLLQDHWEI	cedar_neg
QLLQYEGYK	cedar_neg
QLLRNFASQTV	cedar_neg
QLLRTYSPSV	prime_neg
QLLVSLWGL	cedar_pos
QLMQLIEPA	prime_neg
QLNGELDSLK	prime_neg
QLNPSSRQK	prime_neg
QLPDFVNQL	cedar_pos
QLPFGDPFAV	cedar_neg
QLPGPIWEFL	cedar_neg
QLQHILCSHV	cedar_neg
QLQKANVLL	cedar_pos
QLQREQQHLK	cedar_neg
QLRLFQYNYSY	cedar_neg
QLSCISTYV	cedar_pos
QLSDMHLINV	prime_neg
QLSKYEEIFVK	prime_neg
QLSLGIILV	prime_neg
QLTSLSGIAHK	cedar_neg
QLVECVRSL	prime_neg
QLWKNALQEI	cedar_neg
QLWVDSTPL	cedar_neg
QLYKCEHCGK	cedar_neg
QLYRVLQCA	prime_neg
QLYTLYPGK	prime_neg
QMAGLGPRF	prime_neg
QMIYSAARV	cedar_pos
QMKNPILEL	cedar_neg
QMMWLAELQK	prime_neg
QNGTSSLIIYK	cedar_neg
QPAAHIISELI	cedar_neg
QPACSDSSIV	prime_neg
QPGPPLPPL	prime_neg
QPGSTLLASF	prime_neg
QPHYITVSV	cedar_neg
QPKPRSAAV	prime_neg
QPKYCPVIPL	prime_neg
QPPALSPSY	cedar_neg
QPPAPPTQPL	prime_neg
QPSFSHLVA	cedar_neg
QPSFSHLVAF	cedar_neg
QPSGIILDY	cedar_pos
QPSGVPTSL	cedar_neg
QPTGAPTPL	cedar_neg
QPTGMNQAL	prime_neg
QPYGSSFHAL	cedar_neg
QQEIQILKAL	cedar_neg
QQFAVGSYV	cedar_pos
QQFFFFFFFF	prime_neg
QQFFFFFFF	prime_neg
QQFHLKILFL	cedar_neg
QQLDTAIRLTL	cedar_neg
QQMQVAFSA	cedar_neg
QQQEATPPV	prime_neg
QQQQVVTNK	cedar_neg
QQSRAPLVL	prime_neg
QQWHLDLVLLI	cedar_neg
QQWLALFFV	cedar_pos
QQYKTLAYSF	cedar_neg
QREALRQLL	prime_neg
QRFFRIPFVR	prime_neg
QRIYTGEKPF	cedar_neg
QRLMLRKVAL	cedar_neg
QRTEPPGTFL	prime_neg
QRWMKVNFEV	prime_neg
QRYKCCQINV	prime_neg
QSAEISNNL	cedar_neg
QSAGPGRPL	prime_neg
QSANLVNPK	cedar_neg
QSARLYIVAY	prime_neg
QSARREAKK	prime_neg
QSAYCGWKVRK	cedar_neg
QSDETDQFLV	cedar_neg
QSFCPTPRR	prime_neg
QSFQWYGPKGK	prime_neg
QSFSSTSAL	cedar_neg
QSIAKKSGQK	prime_neg
QSIHTGENPY	prime_neg
QSLFWSIFV	cedar_pos
QSNHLSVSK	cedar_neg
QSQLKGTFK	prime_neg
QSSASTESPAF	cedar_neg
QSYCEPSSY	prime_neg
QSYCEPSSYR	prime_neg
QTAAAVGVLK	cedar_neg
QTACCACRK	prime_neg
QTDTRPWSGPY	cedar_neg
QTEERARLPK	prime_neg
QTIDNIVFL	cedar_neg
QTIRFIGYY	prime_neg
QTITPELPEK	prime_neg
QTKPASLLY	cedar_neg
QTNPVTLQY	cedar_pos
QTQSVVFLY	prime_neg
QTRKNKKLAL	cedar_neg
QTRLKGSLK	cedar_neg
QTSLMMIPY	prime_neg
QTTLQTVSK	prime_neg
QTYTLSQCF	cedar_neg
QVAEKMEKK	cedar_neg
QVLFWLITFV	prime_neg
QVLQQADHTW	prime_neg
QVMPIACGNK	cedar_neg
QVTDFLAPL	cedar_pos
QVTEILPSV	cedar_neg
QVVKGDPPL	cedar_neg
QVWKKHYEARK	prime_neg
QVWNPSFCFK	cedar_neg
QWINLFLQF	cedar_neg
QWPHPSWSAVF	prime_neg
QYIAGEYTLLL	prime_neg
QYIAGEYTLL	prime_neg
QYIAGEYTL	prime_neg
QYIFQLSSLNL	cedar_neg
QYKTLAYSF	cedar_neg
QYMVLVPCL	prime_neg
QYQDLTQGSF	cedar_neg
QYYFECDCF	cedar_neg
RACQDGSVTRY	prime_neg
RAEDLRVAL	prime_neg
RAEHEARVL	prime_neg
RAFFVKFEV	cedar_neg
RAFYILMEK	cedar_neg
RAHALMFWPV	prime_neg
RAILLGAEEK	cedar_neg
RAKLLGAEEK	cedar_pos
RALFALLEIL	cedar_pos
RALFNRAQK	prime_neg
RALLDTANK	prime_neg
RALPPGLSHSK	prime_neg
RALVVPCPR	prime_neg
RAMSTISQL	prime_neg
RANPGKRGK	prime_neg
RANSGFGRGL	cedar_neg
RAPAQSSVTFK	prime_neg
RAQVLQLVAK	prime_neg
RARGRPRKTKL	cedar_neg
RASKARLPV	cedar_neg
RATGAEAAV	prime_neg
RATIVPEL	prime_neg
RATKVTADGK	prime_neg
RAVPPTATPA	prime_neg
RAYQDKWAEK	cedar_neg
RAYRALTETV	prime_neg
RDFQQEIQIL	cedar_neg
RDLRPPGLLR	cedar_neg
REELLAATL	cedar_neg
REFDKIELA	cedar_pos
REFDKIELAY	cedar_pos
REHALLAYM	cedar_pos
REHDLNHTV	prime_neg
REIEGRVMF	cedar_pos
REIPLNQPF	cedar_neg
REMEKGSPF	cedar_neg
REMEKGSPFL	cedar_neg
RERHHQPQTY	cedar_neg
RESAFWLFW	cedar_neg
RESFDPSAFM	cedar_neg
RESSCGTGY	prime_neg
RETRTRCAR	prime_neg
REVFLLKSL	cedar_pos
REVHLHSEPF	prime_neg
RFFRIPFVR	prime_neg
RFFSLVKQMI	prime_neg
RFHTPMYFF	cedar_neg
RFILLVYTL	prime_neg
RFKDIFQEM	cedar_neg
RFLEYLPLRF	cedar_pos
RFLHDLHLL	cedar_pos
RFQQLDTAI	cedar_neg
RFQQLDTAIRL	cedar_neg
RFQRPYRLL	prime_neg
RFREELEGPPL	cedar_neg
RFRHREDRPF	cedar_neg
RFSGVPDSF	cedar_neg
RFWCPFGFIL	prime_neg
RGFIFNLINYY	prime_neg
RGFPRDPSTEF	cedar_neg
RGHCSSFGK	prime_neg
RGLLDSAQRK	cedar_neg
RGLNSNLAY	prime_neg
RGRNSATSADK	cedar_neg
RGRPRKTKL	cedar_neg
RGYWFVNFETK	cedar_neg
RHDLPPYRVYL	cedar_pos
RHQAHWDRYM	prime_neg
RHRLGRDPL	cedar_neg
RHVALGLFL	prime_neg
RHYVMCYEM	prime_neg
RIAGKALKK	cedar_neg
RIALILAGSK	cedar_neg
RIAQCFLRV	cedar_neg
RIAQKIGLI	cedar_neg
RIDRVRGGRQK	prime_neg
RIECIFFSV	cedar_pos
RIFLLIQFV	prime_neg
RIHSGGKPFK	prime_neg
RIHTSAKPYK	prime_neg
RIKQTARK	prime_neg
RILAALFLGL	cedar_pos
RILCSIQGVK	cedar_neg
RILKVTEFK	cedar_pos
RILKVTEFKK	cedar_pos
RILNEGHISHF	cedar_neg
RIMYKWIEPK	cedar_neg
RINLKKRRDSL	cedar_neg
RIPSSDCLPR	prime_neg
RISKIIEAK	prime_neg
RISSMRFCPF	prime_neg
RIYSKIMDLI	cedar_neg
RIYTGEKPFK	cedar_neg
RIYTGEKPY	cedar_neg
RIYVGGKINHI	cedar_neg
RKEASSRHFL	cedar_neg
RKLNFRLFVI	cedar_neg
RKMNASEQEL	prime_neg
RKSKIPRPVL	cedar_neg
RLADAEKLFQL	cedar_neg
RLAVCHFPCL	prime_neg
RLDATQMAMI	prime_neg
RLDATQMAM	prime_neg
RLDAVLMEV	cedar_pos
RLDSTLLLY	cedar_pos
RLDSTLLLYHA	cedar_pos
RLDTSVIFEGL	cedar_neg
RLDWYSLMTSL	cedar_neg
RLDYFMFAV	prime_pos
RLESLSAESY	cedar_neg
RLFDEGKLKA	cedar_neg
RLFEYLRLTSL	cedar_neg
RLFFENPPA	prime_neg
RLFGEAPREL	cedar_pos
RLFHELEAI	prime_neg
RLFKGYEGSLIK	cedar_neg
RLFLGLAIK	cedar_pos
RLFNGNSRGSV	cedar_neg
RLFQAPEFPI	prime_neg
RLFQYNYSY	cedar_neg
RLFTPISAGY	cedar_neg
RLGEHNIEV	prime_neg
RLGIQTFCSRV	cedar_neg
RLGMFVEVK	prime_neg
RLGRDPLLLL	cedar_neg
RLGTWMPFV	prime_neg
RLHDLVFPL	cedar_pos
RLHSEAAYTL	cedar_neg
RLHSSEKPYK	cedar_neg
RLIELIRRA	cedar_neg
RLIELIRRAK	cedar_neg
RLIFQKNQQSK	prime_neg
RLIKHYPGI	cedar_neg
RLIPRVLAM	cedar_neg
RLISGPSVGV	cedar_neg
RLKCPFYGK	cedar_neg
RLLCADPGF	prime_neg
RLLCADPGFV	prime_neg
RLLEEVEELL	prime_neg
RLLEEVEEL	prime_neg
RLLGIPFLQPY	prime_neg
RLLHPHHPL	prime_neg
RLLKHIFST	cedar_neg
RLLLAVTSWV	prime_neg
RLLQGSILA	prime_neg
RLLQRKARA	prime_neg
RLLRGYDQYA	cedar_neg
RLLSECVHAL	prime_neg
RLLSECVHA	prime_neg
RLLVHLQVI	cedar_neg
RLMFAIFFL	prime_neg
RLMFFRPIK	cedar_neg
RLMKSWVQVV	prime_neg
RLMLRKVAL	cedar_neg
RLMLRKVALK	cedar_neg
RLMVAVEEA	cedar_pos
RLMVAVEEAFI	cedar_pos
RLNRNGDFK	prime_neg
RLPDYAEVLL	prime_neg
RLPDYAEVL	prime_neg
RLPLHLYDI	cedar_neg
RLPVGAYEV	cedar_neg
RLQALGPEAPA	prime_neg
RLQALGPEA	prime_neg
RLQASLFRL	prime_neg
RLQGVERIMNK	prime_neg
RLRKRNEYR	cedar_pos
RLSASRRKQQF	prime_neg
RLSCMLARLEV	cedar_pos
RLSDFSEQL	cedar_pos
RLSEDSKVQI	prime_neg
RLSFCGPNRI	prime_neg
RLSFSGPAL	cedar_neg
RLSFSGPALL	cedar_neg
RLSISFENL	cedar_neg
RLSRKLLCK	prime_neg
RLSRPPSPA	prime_neg
RLSSSSSSK	cedar_neg
RLSSSSSVRA	prime_neg
RLSTASFPT	cedar_neg
RLTHPLILLA	prime_neg
RLTHPLILL	prime_neg
RLVAKLANTV	prime_neg
RLVCKAANTK	cedar_neg
RLVPYLEFL	cedar_pos
RLVSEGNLLEV	cedar_neg
RLVVLGIWPI	prime_neg
RLWLEVPDSAV	cedar_neg
RLYEELANFL	prime_neg
RLYEFIVGHFL	cedar_neg
RLYKLILWR	cedar_neg
RLYKRSEPK	prime_neg
RLYLQSHQSV	prime_neg
RLYSKQVTIAI	cedar_neg
RMAISIPIR	cedar_neg
RMCDVQVHK	cedar_neg
RMFSAMRVK	cedar_neg
RMFSTPPSL	prime_neg
RMHTGEKPYV	cedar_neg
RMIDVQNWAYF	cedar_neg
RMIGVGVAV	cedar_neg
RMIHQGREL	prime_neg
RMLDKNPEV	prime_neg
RMLEVPLCQIL	cedar_neg
RMLHWENPV	cedar_neg
RMLQICLLL	prime_neg
RMLRRRAQK	cedar_neg
RMQYSMECF	cedar_pos
RMSSKAMFKV	prime_neg
RMTGLPIPPEI	cedar_neg
RMTGMKEMLRK	prime_neg
RMTRYLESLGA	prime_neg
RMTRYLESL	prime_neg
RMTSQNSQV	prime_neg
RMTVSLVVKM	prime_neg
RMWDFDIFL	cedar_pos
RMWMTLTFF	cedar_neg
RMWMTLTFFV	cedar_neg
RMYSGALLF	cedar_neg
RNMWCCSFDR	prime_neg
RNSSISSPF	prime_neg
RPAARGSRV	cedar_neg
RPAHPAAAPP	prime_neg
RPAWRCVPF	cedar_neg
RPCPGDTTEV	cedar_neg
RPCRRVCAV	cedar_neg
RPEFHVHAPG	cedar_neg
RPGEVIQPL	prime_neg
RPHHDQRSL	cedar_pos
RPHVPESAF	cedar_pos
RPIPIKYKA	cedar_pos
RPIPIKYKAM	cedar_pos
RPISPAPNCI	cedar_neg
RPISPAPNCIV	cedar_neg
RPKATYSVC	prime_neg
RPKATYSVCVM	prime_neg
RPKATYSVCV	prime_neg
RPKRRGRLW	prime_neg
RPKTVEKATDV	cedar_neg
RPLFLDSSHV	prime_neg
RPPIEQANVL	cedar_neg
RPPPSRPISPA	cedar_neg
RPQHPPEALL	prime_neg
RPQHPPEAL	prime_neg
RPRCLCTAV	cedar_pos
RPRKTKLGSM	cedar_neg
RPRQGDLCPP	prime_neg
RPRQGDLCPPS	prime_neg
RPRSASIRDAN	prime_neg
RPRSASIRDA	prime_neg
RPSGLCGASLL	prime_neg
RPSGLCGASL	prime_neg
RPSSCFHPR	prime_neg
RPSSCFHPRR	prime_neg
RPSVLLGDHL	cedar_neg
RPVLWVNTDQV	cedar_neg
RPWSRGPKDPL	prime_neg
RPWSYPSQAE	prime_neg
RPWSYPSQA	prime_neg
RPYGSTVPA	cedar_neg
RPYSQMVTDL	prime_neg
RQAEEIFENI	cedar_neg
RQAEITPTK	prime_neg
RQFTEVHLK	prime_neg
RQGDLCPPSK	prime_neg
RQGEDLAHA	prime_neg
RQMAAILLRR	cedar_neg
RQMPLSSAV	cedar_neg
RQQQEATPPVH	prime_neg
RQQQEATPPV	prime_neg
RQSRLDYFM	prime_neg
RQTEERARLPK	prime_neg
RQTPEPAEL	cedar_neg
RRASKARLP	cedar_neg
RRASSSSSL	prime_neg
RRAYVTPPGT	prime_neg
RRFSSLYSF	cedar_neg
RRGPRLYDL	prime_neg
RRHCRSYNR	cedar_neg
RRHDHEPAE	prime_neg
RRHVLEVEK	cedar_neg
RRIYTGERPY	cedar_neg
RRLAALPMGL	prime_neg
RRLAALPMG	prime_neg
RRLLILGRI	cedar_neg
RRMGWLSLLL	prime_neg
RRMGWLSLL	prime_neg
RRRKSLLLAL	prime_neg
RRSKHPALL	prime_neg
RRTQRYFMK	cedar_neg
RRYEHPLVE	prime_neg
RSAAVEETFR	prime_neg
RSALVRVLVL	prime_neg
RSALVRVLV	prime_neg
RSASIRDANLY	prime_neg
RSDHVALHMK	cedar_neg
RSELNLLV	prime_neg
RSFNLTAGSL	prime_neg
RSHAGAVHK	cedar_neg
RSHRRLRETR	prime_neg
RSKAICVQR	prime_neg
RSKGDIGA	prime_neg
RSLCRGKGKI	prime_neg
RSLLHYMVK	prime_neg
RSLPGKPSK	cedar_neg
RSLRLHRFR	cedar_neg
RSLWREHAGV	prime_neg
RSMQDGEPW	prime_neg
RSMRTVYGLF	prime_pos
RSNPYFVASR	prime_neg
RSQRVRAAM	prime_neg
RSRPVAATA	cedar_neg
RSRPVAATAK	cedar_neg
RSRTPSLPTL	cedar_neg
RSSEKSNSL	prime_neg
RSSEPFQGSYK	cedar_neg
RSSHIFPSL	cedar_neg
RSSSRLGVNEK	cedar_neg
RSYQVRRALER	cedar_neg
RTAECFLRV	cedar_neg
RTAKQNPLTK	cedar_neg
RTAKQNPLTKK	cedar_neg
RTAPRPGSQK	cedar_neg
RTARTIWISK	prime_neg
RTAVYHEIHI	cedar_pos
RTAWWGKVPR	prime_neg
RTDFLIQTVAK	cedar_neg
RTDVHIWVFR	cedar_neg
RTDVKAYNVT	cedar_pos
RTFREVLKEEY	prime_neg
RTFSTFDFY	prime_neg
RTFVAAYGK	prime_neg
RTFVAAYGKSY	prime_neg
RTGKAAGLL	cedar_neg
RTGKSKYTF	prime_neg
RTISAYKAPR	prime_neg
RTLGRTGDL	prime_neg
RTMAATTLK	cedar_pos
RTMMFFAEH	prime_neg
RTNTAILETL	cedar_pos
RTNTGILETLK	cedar_pos
RTNTVILETLK	cedar_pos
RTPDGFLLV	cedar_neg
RTPDMIQQSR	prime_neg
RTQDAEFLK	cedar_pos
RTQDVSVQVER	cedar_pos
RTRARESPHF	cedar_neg
RTSSTQQDNPK	cedar_pos
RTTIESPSRK	cedar_neg
RTVPYILRV	cedar_neg
RVAAGIICTL	prime_neg
RVADETYKAFL	cedar_neg
RVADINDHAL	prime_neg
RVAKYGKTL	prime_neg
RVAKYGKTLY	prime_neg
RVALLSWTK	cedar_neg
RVARKLYRY	prime_neg
RVARLGYKDV	prime_neg
RVCGPCSTY	cedar_pos
RVFNKYPTLK	cedar_neg
RVFRDSWAL	cedar_neg
RVGACPGRDR	prime_neg
RVGDITLRCPV	prime_neg
RVGYLTQAK	prime_neg
RVHTGEKPYK	prime_neg
RVIHLLVEK	cedar_pos
RVKENEAILK	prime_neg
RVLEAQSFI	cedar_neg
RVLFAVYHM	prime_neg
RVLHFKNSY	cedar_neg
RVLQCANLL	prime_neg
RVLSHDSIFI	cedar_neg
RVLSPVIIK	prime_neg
RVMDISYLNL	cedar_neg
RVPALPFLL	prime_neg
RVPSISFRI	prime_neg
RVQQIVIHREY	cedar_neg
RVRAMAICK	prime_neg
RVRDFIQMK	prime_neg
RVRKIKPFSEI	cedar_neg
RVRQDGQFL	prime_neg
RVRVMAIYK	cedar_pos
RVRVRQDGQFL	prime_neg
RVSTLRVSL	cedar_pos
RVTRAAAACL	prime_neg
RVYEDILGM	prime_neg
RVYGVYQVVEY	prime_neg
RVYISYLDCI	cedar_pos
RVYKCIFNH	cedar_pos
RVYKCIFNHK	cedar_pos
RWMKVNFEVF	prime_neg
RWMKVNFEV	prime_neg
RWQKVLVNL	cedar_neg
RWQRSQHSYK	prime_neg
RWVFSGMRPW	cedar_neg
RYAAVYRPL	prime_neg
RYAGLMVPPL	cedar_neg
RYDLFVYPKF	prime_neg
RYDLFVYPK	prime_neg
RYFRRKPVPFF	prime_neg
RYFRRKPVPF	prime_neg
RYFYTAVSR	prime_neg
RYGELTKII	prime_neg
RYGGSTIAAGF	prime_neg
RYHYNATLL	prime_neg
RYLETNKYCRM	cedar_neg
RYLYHRVDVI	cedar_pos
RYLYHRVDVIF	cedar_pos
RYPRYLYKL	cedar_neg
RYSVFFQLL	cedar_neg
RYTEGAELM	cedar_neg
RYVAICCTL	prime_neg
RYVLHVVAA	cedar_neg
RYVPLTPWF	cedar_neg
RYVPLTPWFL	cedar_neg
RYVPLTPWFLM	cedar_neg
RYYCEVLPGEI	prime_neg
RYYICTAQNL	prime_neg
RYYRVSILL	cedar_pos
RYYVGHKAKF	cedar_pos
SAAASSSVQR	prime_neg
SAAGLLVPM	prime_neg
SAAWAVHPS	prime_pos
SADGGGLS	prime_neg
SAEGSRKAL	prime_neg
SAELNAALEK	prime_neg
SAFIEPRYHV	cedar_neg
SAFWLFWGL	cedar_neg
SAIGGEGPQRY	cedar_neg
SALVRVLVL	prime_neg
SAPRSFAPAGK	prime_neg
SAQHRRLPLR	prime_neg
SAQSHCSTY	cedar_neg
SAREAGSAV	prime_neg
SARMWMTLTF	cedar_neg
SARNSSISSPF	prime_neg
SASCYSSSCY	cedar_neg
SASDLRNQL	cedar_neg
SASIRNANLY	prime_neg
SASLHPATV	cedar_neg
SASTESPAF	cedar_neg
SAVLVIKAHK	prime_neg
SAVMGRSYAPY	prime_neg
SAVPSAGGSV	prime_neg
SAWRNIAAR	cedar_neg
SAWRNIAARLL	cedar_neg
SAWTDTQRL	cedar_neg
SAYCGWKVRK	cedar_neg
SAYKHMKLHK	prime_neg
SAYYISTFNL	prime_neg
SCDSLCGGY	prime_neg
SCFHPRRER	prime_neg
SCMGGMNWR	cedar_pos
SCSNFLLLAY	prime_neg
SCSRAVPQV	cedar_pos
SCTCPTGIDL	cedar_neg
SCYWFGNCRK	prime_neg
SEDLETPEAEW	prime_neg
SEDSGNFSV	prime_neg
SEIISFKSL	cedar_pos
SEITKQEKDF	cedar_neg
SEKLRHMLL	cedar_pos
SELFRSGLDSY	cedar_neg
SELKDYLWQM	prime_neg
SELMKVSAM	cedar_neg
SELRKTLGPIW	prime_neg
SEQELAACQL	prime_neg
SESELKDYL	prime_neg
SFEAAAWYW	cedar_neg
SFEAAAWYWHF	cedar_neg
SFHFQQKEI	cedar_neg
SFKKVTLRR	prime_neg
SFMVDTRGGSM	cedar_neg
SFPRSSEPF	cedar_neg
SFQSLLYLL	cedar_neg
SFSISSILEW	cedar_neg
SFSLPKSVPLF	cedar_neg
SFSSAPMPQI	cedar_neg
SFVALSTCHEL	cedar_neg
SFYPAEITL	prime_neg
SGAPSLKGK	cedar_neg
SGEYLSLSFK	prime_neg
SGFFLRTLY	cedar_neg
SGLYVFRNER	cedar_pos
SGNVNADSVVY	prime_neg
SGVRVVGPL	prime_neg
SHCARPREH	prime_neg
SHCPSAMGI	cedar_neg
SHETVIIEL	cedar_pos
SHIVTYYPGK	cedar_neg
SHLAVVGMF	cedar_neg
SHLLKGDENL	prime_neg
SHRRLRETR	prime_neg
SIAECETRLGK	cedar_neg
SIAKKSGQK	prime_neg
SIAPEIALEL	cedar_pos
SIDAVAVTPL	cedar_neg
SIGDYYTCAR	cedar_neg
SIGPELPTPEV	cedar_neg
SIINRTPWSL	prime_neg
SIISLFVLL	cedar_neg
SIITLMMNPLI	prime_neg
SIITLMMNPL	prime_neg
SILDNQLVR	prime_neg
SILEQMHRK	cedar_pos
SILFLIISY	prime_neg
SILFLIISYVA	prime_neg
SILFLIISYV	prime_neg
SILGNTTIIL	prime_neg
SILGNTTIILV	prime_neg
SILKGYRLY	cedar_neg
SILMHGLVSL	cedar_pos
SIMAPANFFV	prime_neg
SIPDPSFPL	cedar_neg
SIPGTMGALY	prime_neg
SIPIGWSHF	prime_neg
SIPPASYHPK	prime_neg
SIQNDVPFLLK	prime_neg
SISAFLYFL	prime_neg
SISCHVFCL	cedar_pos
SISDEIAKA	cedar_neg
SISDEIAKAV	cedar_neg
SISFENLDTA	cedar_neg
SISSAATPY	prime_neg
SISSAATPYR	prime_neg
SISSEQTFY	prime_neg
SISSFLLVR	cedar_neg
SITFRIPVSR	prime_neg
SITRKNSRTPL	cedar_neg
SIWGFSGNVNA	prime_neg
SIWGFSGNV	prime_neg
SIYFCIYFL	cedar_neg
SIYSIVKIK	prime_neg
SKIPRPVLW	cedar_neg
SKVGPWRKAR	prime_neg
SLAACVWGL	prime_neg
SLAATPEIRV	cedar_neg
SLADEAEVYL	prime_pos
SLADMLDHA	cedar_neg
SLAHHIQLI	cedar_neg
SLAHHIQLIF	cedar_neg
SLANFGGWV	cedar_neg
SLAPLSPRV	cedar_pos
SLASFATQKMI	prime_neg
SLASFATQKM	prime_neg
SLATAQIAR	prime_neg
SLCRGKGKI	prime_neg
SLCRMTGMK	prime_neg
SLDCARLPTRK	prime_neg
SLDLPLNPL	prime_neg
SLDLTTSPV	cedar_neg
SLDQPVTALNV	cedar_neg
SLDTAKVRL	cedar_neg
SLDVLMAVAIL	cedar_neg
SLEEEAVSV	prime_neg
SLEEINCTI	cedar_neg
SLEEKDHYI	prime_neg
SLEEKDHYISV	prime_neg
SLEFENKQAL	cedar_neg
SLEKMVCLV	cedar_neg
SLEKMVCLVL	cedar_neg
SLESLGYHCK	prime_neg
SLETPSPPL	cedar_neg
SLFALGNVI	cedar_neg
SLFALGNVISA	cedar_neg
SLFEGIDFYT	prime_neg
SLFGLSFVR	prime_neg
SLFINTSSY	prime_neg
SLFKGLHHKA	prime_neg
SLFNGVFPR	prime_pos
SLFNIKNTQQL	cedar_neg
SLFRFSFNA	prime_neg
SLFRLVPNV	prime_neg
SLFTANFHL	prime_neg
SLFWQTAMV	cedar_neg
SLGAAKPFAHL	prime_neg
SLGAQTAAA	cedar_neg
SLGDHNFLRK	prime_neg
SLGKAQTAQV	cedar_neg
SLGTFVFYLL	prime_neg
SLGTFVFYL	prime_neg
SLGYHCKYK	prime_neg
SLHKGSLYPR	cedar_neg
SLIEEDLTEV	cedar_neg
SLIHYTAQI	cedar_neg
SLIKNMLVALK	prime_neg
SLILLENPV	prime_neg
SLILLENPVV	prime_neg
SLIQRINLKK	cedar_neg
SLISEQWVV	prime_neg
SLITANEQFKA	prime_neg
SLITANEQF	prime_neg
SLIVGGIVGI	cedar_neg
SLKETEESI	cedar_neg
SLKKSFNFF	cedar_neg
SLKQKKKP	prime_neg
SLKTLMSHY	cedar_neg
SLLAKREVAL	prime_neg
SLLALASLV	prime_neg
SLLALVHVV	prime_neg
SLLAMNHGK	prime_neg
SLLGAEGVPV	cedar_neg
SLLHYMVKQL	prime_neg
SLLKMICQEV	prime_neg
SLLKYHTSGSK	prime_neg
SLLMNIEVV	prime_neg
SLLMWITQA	cedar_pos
SLLMWITQAL	cedar_pos
SLLMWITQV	cedar_pos
SLLPNNAADL	cedar_neg
SLLQGSPHV	cedar_pos
SLLQLPLAV	cedar_neg
SLLQTKNYSEI	cedar_neg
SLLRAAFFGK	cedar_neg
SLLRSLENV	cedar_pos
SLLSHPLPEF	cedar_neg
SLLSLLYAL	prime_neg
SLLSLPLSL	cedar_neg
SLLTNWPFV	cedar_pos
SLLTPPSTK	cedar_neg
SLLTQLRAEV	cedar_neg
SLLTTDDAVV	cedar_neg
SLLWMNLFV	cedar_pos
SLLWMNLFVGF	cedar_neg
SLLYPHSLSSK	cedar_neg
SLMCGTWYK	prime_neg
SLMDKVSNGI	cedar_neg
SLMEHWALGA	prime_neg
SLMEHWALG	prime_neg
SLMPQPLADGI	cedar_neg
SLMTPNTITM	cedar_neg
SLMTPNTITMI	cedar_neg
SLMTRETWEV	prime_neg
SLMVISMACV	prime_neg
SLNDYKPPV	cedar_neg
SLNICKENEV	cedar_neg
SLNNAVIELA	prime_neg
SLNNAVIEL	prime_pos
SLNQEIASL	cedar_neg
SLNQEMSSLL	cedar_neg
SLNSEEKLDSV	cedar_neg
SLPFQFAHRL	cedar_neg
SLPKSVPLF	cedar_neg
SLPMKNFPV	cedar_pos
SLPPQRLMIL	prime_neg
SLPSKNTPK	prime_neg
SLPSNVLSSL	cedar_neg
SLQAEHRLLK	prime_neg
SLQALVGNPI	prime_neg
SLQDHCCRAV	prime_neg
SLQPRGSFK	cedar_neg
SLQPVQALGAV	cedar_neg
SLQRLMLRKV	cedar_neg
SLQSFCPTPR	prime_neg
SLRSHHYSL	cedar_pos
SLSAIRTVAK	prime_neg
SLSALFNIGL	prime_neg
SLSEECYWSL	cedar_neg
SLSEECYWSLL	cedar_neg
SLSELQRLV	prime_neg
SLSEQLLQL	cedar_neg
SLSIGSAEV	prime_neg
SLSKGDCQTL	cedar_neg
SLSLRPSAR	prime_neg
SLSPIEMKK	prime_neg
SLSPLQEKQGL	cedar_neg
SLSRHASLLY	cedar_neg
SLSSFLFSL	prime_neg
SLSSFRIHER	cedar_neg
SLSSLTATT	cedar_neg
SLSSLTATTQA	cedar_neg
SLSSSGAPSL	cedar_neg
SLSSSGAPSLK	cedar_neg
SLSSVTLLL	prime_neg
SLSTIKDIISL	cedar_neg
SLSTSLSSV	prime_neg
SLSTSPSEL	cedar_neg
SLTATTQAPM	cedar_neg
SLTDPTLIADA	prime_neg
SLTDPTLIA	prime_neg
SLTHNAVCPI	cedar_neg
SLTKKITLL	cedar_neg
SLTPASPMEV	prime_neg
SLTTAATGTV	cedar_neg
SLVAAWYSGV	cedar_neg
SLVALAFVI	prime_neg
SLVALAFVIR	prime_neg
SLVGPLPSGSV	cedar_neg
SLVKFLEFER	prime_neg
SLVLQPLLPV	cedar_neg
SLVSEDFLSSV	cedar_neg
SLVSSSRWLV	prime_neg
SLVVKMFEL	prime_neg
SLWKKLLEST	prime_neg
SLWPAAQEL	prime_neg
SLWREHAGV	prime_neg
SLWREHAGVV	prime_neg
SLYCHTYAEKV	cedar_neg
SLYDLDIEA	cedar_pos
SLYDNIMLH	prime_neg
SLYGGDAVV	prime_neg
SLYGNSDLTI	cedar_neg
SLYLKIHLK	cedar_neg
SLYLRPVLI	cedar_neg
SLYLVFQMGV	prime_neg
SLYNFLNLTAL	cedar_neg
SLYNFLNLT	cedar_neg
SLYTTEMDLR	cedar_neg
SMACVGFFL	cedar_pos
SMAHVSVVPVF	cedar_neg
SMAKTSTSL	cedar_neg
SMASEDVAV	cedar_neg
SMAYPSLGA	prime_neg
SMCKKILTGV	prime_neg
SMHIDNNTLL	cedar_neg
SMIPKAIESF	cedar_neg
SMIPKAIESFL	cedar_neg
SMIQIITGQL	cedar_neg
SMIQMLFYM	cedar_neg
SMLDLDIQEL	prime_neg
SMLRNERQFK	cedar_neg
SMNDGLLRL	prime_neg
SMPSSPPLA	prime_neg
SMQDGEPWRDV	prime_neg
SMSINTFPV	prime_neg
SMSPVLHTENK	cedar_neg
SMTGIVYSL	cedar_neg
SMVPREAAFIL	cedar_neg
SMYKDVTSV	cedar_neg
SNCCWSIFYV	prime_pos
SNISPWWNF	cedar_neg
SNTSRYATAL	cedar_neg
SNYYCGLRYGY	prime_neg
SNYYCGLRY	prime_neg
SPAAPAESPA	prime_neg
SPAFTESPV	cedar_neg
SPAHLTPQVGV	prime_neg
SPAHLTPQV	prime_neg
SPAKKAAPA	prime_neg
SPAPPRRRRSA	cedar_neg
SPCASSSSSF	prime_neg
SPCSTRKQLQY	prime_neg
SPDGAAGEGPA	prime_neg
SPDLPGTHL	cedar_neg
SPDLPGTHLI	cedar_neg
SPDSPQLPW	prime_neg
SPEVPKPSL	prime_neg
SPEVPKPSLSF	prime_neg
SPFLSQRVA	cedar_neg
SPFLSQRVAFL	cedar_neg
SPFTATSL	prime_neg
SPGDAHRESL	cedar_neg
SPGGVQEAL	cedar_neg
SPGPREALSHL	prime_neg
SPGPRNAPAA	prime_neg
SPGPRNAPA	prime_neg
SPGSLPQPI	prime_neg
SPHCTNLAL	prime_neg
SPHLARHRHL	cedar_neg
SPIFKQKKNL	prime_neg
SPILENPFF	cedar_neg
SPILENPFFSI	cedar_neg
SPILWYAPESL	cedar_neg
SPKIPSGAY	prime_neg
SPLALPADI	prime_neg
SPLALPADIV	prime_neg
SPLQEKQGL	cedar_neg
SPLYSVKSL	cedar_neg
SPMEKAISL	cedar_pos
SPMIVGSPWAL	prime_neg
SPMIVGSPWA	prime_neg
SPMIVGSPW	prime_pos
SPMTVKEEFL	prime_neg
SPMTVKEEF	prime_neg
SPNKYLPVKEI	cedar_neg
SPNQSSTSNEM	cedar_neg
SPPHPGRLPDL	cedar_pos
SPPTSPVQTPL	cedar_neg
SPRDEKEEM	cedar_neg
SPRDEKEEMM	cedar_neg
SPRRHDHEPA	prime_neg
SPSGLVSITF	prime_neg
SPSKTSLTL	cedar_neg
SPSRKLAAH	cedar_neg
SPSRKLAAHL	cedar_neg
SPSVNSQNPTV	prime_neg
SPVKYMTRI	prime_neg
SPVLRSHSF	cedar_neg
SPVLTFAGVL	prime_neg
SPVLTFAGV	prime_neg
SPVPQGARWRL	cedar_neg
SPVQTPLEV	cedar_neg
SPVQTPLEVR	cedar_neg
SPVQTPLEVRL	cedar_neg
SPVTFPAAA	cedar_neg
SPWALTQPLGL	prime_neg
SPWALTQPL	prime_neg
SPWKAGALLL	prime_neg
SPWKAGALL	prime_neg
SPWKGALLLL	prime_neg
SPWKGALLL	prime_neg
SPWWNFGSLL	cedar_pos
SPYLIVMGAL	prime_neg
SPYPHHHHPH	prime_neg
SQAESDMSK	prime_neg
SQAQKATSLYR	prime_neg
SQATSEQLRK	prime_neg
SQDDNIVGL	cedar_neg
SQDQELPSV	cedar_neg
SQFARVPGY	prime_neg
SQFARVPGYV	cedar_neg
SQGEPALLQPV	cedar_neg
SQGSRSSHI	cedar_neg
SQIAHLVQHR	cedar_neg
SQLHAVPVLLV	cedar_neg
SQLKGTFKGHK	prime_neg
SQLQELKNLK	prime_neg
SQMEELPSV	cedar_neg
SQNNLVDEEK	prime_neg
SQNSSTICCV	cedar_neg
SQPPSDLSY	cedar_neg
SQSPRSPPGK	cedar_neg
SQSPSSFSM	cedar_neg
SQTTSLFNGV	prime_neg
SQVYLILQV	prime_neg
SQWDLQPDTDY	prime_neg
SREMEKGSPF	cedar_neg
SRFFSLVKQM	prime_neg
SRKEVTEHL	prime_neg
SRLDYFMFA	prime_neg
SRLDYFMFAV	prime_neg
SRLLVRPTSF	cedar_neg
SRPNLKYTI	prime_neg
SRQKLFREV	prime_neg
SRTNTAILETL	cedar_pos
SRTNTAILEV	cedar_pos
SRVILFSPL	cedar_neg
SRYAFLVEL	prime_neg
SSAAAPFPL	cedar_pos
SSAATPYRIR	prime_neg
SSADHPGASK	cedar_neg
SSAKAAGLCY	prime_neg
SSAKAGLCY	prime_neg
SSASTESPAF	cedar_neg
SSCAPPLHR	cedar_neg
SSCFHPRRER	prime_neg
SSCMGGMNLR	cedar_neg
SSCMGGVNR	cedar_neg
SSDFTVLQEI	prime_neg
SSDSQEENY	prime_neg
SSDTAGPSSY	prime_neg
SSEDDGFFLGK	cedar_pos
SSEIISFKSL	cedar_pos
SSEMAENEDY	prime_neg
SSFGLHLFK	prime_neg
SSFHALEEK	cedar_neg
SSFLVPSLPY	prime_neg
SSFPKPPSF	cedar_neg
SSFVHVEQY	prime_neg
SSGAPSLKGK	cedar_neg
SSGFCNIAVK	cedar_neg
SSHRHLHVVY	cedar_neg
SSHSPSLSL	cedar_neg
SSHWQQLMLK	prime_neg
SSINISAFK	prime_neg
SSIRSFVLQY	prime_neg
SSIYLHKPR	prime_neg
SSIYSIVKIK	prime_neg
SSKEDLAAM	prime_neg
SSKKVMRTK	cedar_neg
SSLDLTTSPV	cedar_neg
SSLKTLMSHY	cedar_neg
SSLRIRSVER	prime_neg
SSLSSPQPQL	cedar_neg
SSLSSSGAPSL	cedar_neg
SSMESRLLK	cedar_neg
SSMISDEPQR	prime_neg
SSNLFSSSSF	cedar_neg
SSPAILLKK	prime_neg
SSPTKSSEDK	prime_neg
SSRCECEDVY	prime_neg
SSRCECEDVYY	prime_neg
SSRTRHYVTL	cedar_neg
SSSGAPSLK	cedar_neg
SSSGAPSLKGK	cedar_neg
SSSIYLHKPR	prime_neg
SSSIYSIVK	prime_neg
SSSMDPNDMMR	prime_neg
SSSRQLDLK	prime_neg
SSSSRQLDLK	prime_neg
SSTCSSTLY	cedar_neg
SSTSNRSSTW	cedar_neg
SSVGNRQVGK	prime_neg
SSVPTGHATF	cedar_neg
SSVRATLRLY	prime_neg
SSVSTKESPAK	prime_neg
SSWHNADDDR	cedar_neg
SSYIASFTY	prime_neg
SSYSPLNSLI	prime_neg
SSYTGFANK	cedar_pos
SSYTPPQMTPH	prime_neg
STAFDFLAV	cedar_neg
STAFSWPVY	prime_neg
STAKSTTWTY	cedar_neg
STATSPFASM	prime_neg
STDTQPCSER	prime_neg
STEDCLILLF	prime_neg
STEQCAFCK	cedar_neg
STFFLAHGLK	prime_neg
STFFSSVTVAL	cedar_neg
STFNLDHALV	prime_neg
STGCQLIPIIK	prime_neg
STGDATPLPV	cedar_pos
STGHTTPLPV	prime_neg
STGLKMAMEK	prime_neg
STGQHTPLPV	prime_neg
STIARPTIGNK	cedar_neg
STIMGSYLGV	cedar_neg
STKESPAKK	prime_neg
STKYRGYMLPL	cedar_neg
STLILVIFSY	prime_neg
STLLFTLSYPY	prime_neg
STLSGEWFTF	cedar_neg
STLSGVNFEL	prime_neg
STMHILTRI	cedar_neg
STMSFGILL	prime_neg
STPLPGTRVR	cedar_pos
STRPVLVFER	cedar_neg
STSDYLSQSY	prime_neg
STSGALDTIQY	cedar_neg
STSSPPPGL	prime_neg
STTSQGPRK	prime_neg
STVHGLYKDLY	prime_neg
STVQLIMQL	cedar_pos
STVSRPNLK	prime_neg
STYSQKSAK	prime_neg
SVACINLSFCL	cedar_neg
SVFNICDVPL	cedar_neg
SVFNTWNPM	cedar_neg
SVFNTWNPMWV	cedar_neg
SVFNYSINS	prime_neg
SVFTLTADR	cedar_neg
SVFTLTADRY	cedar_neg
SVFYFRSPGR	prime_neg
SVGDFSQEF	cedar_neg
SVGNRQVGK	prime_neg
SVIKALEQF	cedar_neg
SVISQLMKK	cedar_neg
SVISQLMK	prime_neg
SVIVRTLSGK	cedar_neg
SVIVRTSSGK	cedar_neg
SVKDTFLQQK	prime_neg
SVKNPISKK	prime_neg
SVKPHLCSL	cedar_neg
SVLDVGVAV	cedar_neg
SVLENFTIFL	cedar_pos
SVLEYQTAVI	cedar_neg
SVLLPENYITK	cedar_neg
SVLNYFKPY	cedar_neg
SVLNYFKPYL	cedar_pos
SVMDSIDVKI	cedar_neg
SVMIACNIR	prime_neg
SVPTGHATF	cedar_neg
SVQAPVPPK	cedar_neg
SVQDKCVEM	cedar_neg
SVQDVSLFV	cedar_pos
SVQKDVLEY	cedar_neg
SVRATLRLY	prime_neg
SVSDAVATF	prime_neg
SVSDAVATFY	prime_neg
SVSDISEYR	cedar_neg
SVSDISEYRV	cedar_neg
SVSENVLKILV	cedar_neg
SVSTKESPAKK	prime_neg
SVSTKESPAK	prime_neg
SVTGYYGNWFV	cedar_neg
SVTNEFCLK	prime_pos
SVTSLLYPHSL	cedar_neg
SVVDVFFQL	prime_neg
SVVNPIIYSY	prime_neg
SVVPFLPSV	cedar_neg
SVWGVELPSM	prime_neg
SVWILCDAHCL	cedar_neg
SVYGIVVMNR	cedar_neg
SVYSCVALPYF	cedar_neg
SWSAVFVVYTF	prime_neg
SWYRIYSKI	cedar_neg
SYARPRSASI	prime_neg
SYAVRCAFYQL	cedar_neg
SYCEPSSYR	prime_neg
SYEKIYLDF	cedar_neg
SYFLIFFLCTM	prime_neg
SYGNIIWTLL	prime_neg
SYGNIIWTL	prime_neg
SYGPSQYYHL	prime_neg
SYGRVLFAV	prime_neg
SYGVRFNSF	cedar_neg
SYLDSGIHF	cedar_neg
SYLKEFPKELK	prime_neg
SYLKEFPKEL	prime_neg
SYMCASNEPF	prime_neg
SYMIMEIEL	cedar_pos
SYSHKVDIFFL	cedar_neg
SYSLESDQLI	prime_neg
SYSPLNSLI	prime_neg
SYSQAQALL	prime_neg
SYSSLTSLI	prime_neg
SYVSYKMLL	prime_neg
SYWNRLQFL	cedar_neg
SYYKISSDK	cedar_neg
TAHLNCNLF	cedar_pos
TAKQAHLTTLK	cedar_neg
TAKSTTWTY	cedar_neg
TALPFCGPR	prime_neg
TALPQSILLF	cedar_neg
TAMDIFVTV	cedar_pos
TANGVKPLQK	prime_neg
TARTIWISN	prime_neg
TASARPVSSF	prime_neg
TATPAYPGV	prime_neg
TATPAYPGVV	prime_neg
TATSPFASM	prime_neg
TAVAGLASY	cedar_neg
TAVIYVNSCL	prime_neg
TAVSLGRLKL	cedar_neg
TAWWGKVPRK	prime_neg
TAYGLPDTK	prime_neg
TAYQNQQFTK	prime_neg
TDFGRAKLL	cedar_neg
TEATFFPPL	cedar_neg
TEATFFPPLL	cedar_neg
TEDDAKTVT	prime_neg
TEDEHFEFY	cedar_pos
TEDYMIHII	cedar_pos
TEITLTWQR	prime_neg
TELERFLEY	cedar_neg
TELSEENIEF	prime_neg
TELSEENIEFW	prime_neg
TEMEFSTSL	prime_neg
TEMSAICQVY	cedar_neg
TESPFEQHI	prime_pos
TFADTAALL	cedar_neg
TFAYRTKLER	prime_neg
TFFLAHGLK	prime_neg
TFITIGDTNF	cedar_neg
TFRNHIVACVF	prime_neg
TFYFSNMLEF	cedar_neg
TGAEAAVEVL	prime_neg
TGLPHAPAL	prime_neg
THKENPVVDV	prime_neg
THNLIFVFYML	cedar_neg
THRATPVFL	prime_neg
THRATPVFLV	prime_neg
THVSDMSVVL	prime_neg
TIAAGFVTEIK	prime_neg
TIAATERRVK	prime_neg
TICDPNKSFSV	prime_neg
TIFHPEQNVQK	prime_neg
TIQKFLSLK	cedar_pos
TISAYKAPR	prime_neg
TISKLYIPK	cedar_neg
TITAPSLSGK	cedar_neg
TITMQLMNR	cedar_neg
TITMQLMNREK	cedar_neg
TITSSAELLK	prime_neg
TIVDDIGHGV	prime_neg
TIVEHKYPSV	cedar_neg
TIYVFEIRAR	cedar_neg
TLAEDLNLL	cedar_pos
TLALPVINNL	cedar_neg
TLAYFLPRPPL	cedar_neg
TLAYSFQSL	cedar_neg
TLAYSFQSLL	cedar_neg
TLCIVCTVDL	cedar_neg
TLDECGLSYL	cedar_neg
TLDQSTMHI	cedar_neg
TLDWLLQTPK	cedar_pos
TLDWSKNAV	cedar_neg
TLFHTFYEL	cedar_neg
TLFHTFYELL	cedar_neg
TLFNGLSCK	prime_neg
TLFPLPFFI	prime_neg
TLFSALWAL	cedar_pos
TLFTLSYGV	prime_neg
TLFTMVGTV	cedar_pos
TLFWAPPER	cedar_neg
TLGACLSLA	prime_neg
TLGSYPICL	prime_neg
TLHGFMMYL	cedar_pos
TLHHLLMSQV	cedar_neg
TLHVSPGASK	prime_neg
TLHYTTAMSPK	prime_neg
TLIAIFPYARL	cedar_pos
TLIGLPWSFL	cedar_neg
TLIHTLEEK	prime_neg
TLIQCSHFT	cedar_neg
TLKALAGLSL	prime_neg
TLKALEMGAVK	prime_neg
TLLFTLSYPY	prime_neg
TLLLPHYASAK	cedar_neg
TLLQRVARL	prime_neg
TLLSLPVHFNL	cedar_neg
TLLSLSLQV	prime_neg
TLLSPLGAEI	prime_neg
TLLSQVNKV	cedar_neg
TLLYFIALTV	prime_neg
TLMMNPLIY	prime_neg
TLMMNPLIYSL	prime_neg
TLMTDTQFVL	cedar_neg
TLMYACCLLM	prime_neg
TLNEKIILQA	prime_neg
TLNEKIILQAV	prime_neg
TLNITSQGQK	prime_neg
TLNLRLSAV	cedar_neg
TLPEEFHEF	cedar_pos
TLPGTLLLDEV	cedar_neg
TLPQSVSKQSV	cedar_neg
TLPTVKLAEV	cedar_neg
TLQELSHAL	cedar_neg
TLQQPEASVLY	prime_neg
TLQQPEASV	prime_neg
TLQRNTFLGL	cedar_neg
TLRCWALSFY	prime_neg
TLSASAAWAV	prime_pos
TLSASAAWV	prime_neg
TLSDNSREAKV	cedar_neg
TLSDVLFRL	prime_neg
TLSGEWFTFY	cedar_neg
TLSGEWFTFYL	cedar_neg
TLSGFFLRTL	cedar_neg
TLSGFFLRTLY	cedar_neg
TLSGVNFEL	prime_neg
TLSGVNFELV	prime_neg
TLSQQLPREPV	cedar_neg
TLSYPYDKTGK	prime_neg
TLSYPYGSK	prime_neg
TLTFQDVAVY	prime_neg
TLTQHEMIFK	prime_neg
TLTVTSLYLV	prime_neg
TLVHDETPHL	prime_neg
TLVPDLLSPK	cedar_neg
TLVRCAKAK	cedar_neg
TLVYPATEK	cedar_neg
TLWCSPIKV	cedar_pos
TLWEGGLFKL	cedar_neg
TLWPEDQKL	prime_neg
TLWPEFQKL	prime_neg
TLYATVGKEAV	cedar_neg
TLYLGTSGI	cedar_neg
TLYLPHYASAK	cedar_neg
TLYPGKDGK	prime_neg
TLYSLTLLY	cedar_pos
TLYSPRGEK	cedar_neg
TMAAISNTV	cedar_pos
TMDDDNLEL	prime_neg
TMDKVVQIL	cedar_neg
TMFGLPFAT	cedar_neg
TMHTYKELI	prime_neg
TMIEEYDSG	cedar_pos
TMIEEYDSGL	cedar_pos
TMLSPLEDEL	prime_neg
TMLTKTWHSSA	cedar_neg
TMMFFAEHDY	prime_neg
TMQLMNREK	cedar_neg
TMSFSHLFYL	cedar_pos
TMSLYDLDIEA	cedar_pos
TMYRSPRFLV	prime_neg
TPAVVEISDST	prime_neg
TPAYPGVDM	prime_neg
TPEEGGQAL	prime_neg
TPEPAELSL	cedar_neg
TPGKTSLLSL	prime_neg
TPITMTLPF	cedar_neg
TPKTEPRRRK	cedar_neg
TPLNRAIESF	cedar_neg
TPLPAPQQY	cedar_neg
TPLPAPQQYIV	cedar_neg
TPLPGTRVRA	cedar_pos
TPLTKDVTL	cedar_neg
TPLVIKIDKPY	cedar_neg
TPNTLPNYQSF	cedar_neg
TPNVHRTKR	prime_neg
TPPPGTRVRV	prime_neg
TPQKLQHLQQL	prime_neg
TPSAAVKLI	cedar_neg
TPSLPTLPT	cedar_neg
TPSLPTLPTR	cedar_neg
TPSRGLNKV	prime_neg
TPTARSSPLL	prime_neg
TPTARSSPL	prime_neg
TPTDVTARHL	cedar_pos
TPTVPSSSF	cedar_pos
TPWPPPPAT	prime_neg
TPYRIPSDQVF	prime_neg
TPYTRDQIMTI	cedar_neg
TQAKWWELLFF	prime_neg
TQAKWWELLF	prime_neg
TQAKWWELL	prime_neg
TQASNSTQL	prime_neg
TQFLYIWFK	cedar_pos
TQFNAWWHIL	cedar_neg
TQFWCAVAL	cedar_neg
TQGSAAELI	cedar_neg
TQHEMIFKR	prime_neg
TQKNLKELF	prime_neg
TQLFYALGIV	cedar_neg
TQLFYALGIVF	cedar_neg
TQLMPFGSLL	cedar_pos
TQLNPSSRQK	prime_neg
TRARNEYLLSL	cedar_neg
TRKNKKLAL	cedar_neg
TRKNSRTPL	cedar_neg
TRLSQTTTPM	prime_neg
TRNIIKYNL	cedar_neg
TRVRVMAIYK	prime_neg
TSDVNSLVGK	cedar_neg
TSDYLSQSY	cedar_pos
TSFESMIQY	prime_neg
TSIDRFLAV	prime_neg
TSIVVSQTL	cedar_neg
TSLSGIAHK	cedar_neg
TSNHESQVTF	cedar_neg
TSSGLYVFR	cedar_neg
TSYGRSLRY	prime_neg
TSYMPCSAYQK	cedar_neg
TTAHGSSILDR	prime_neg
TTATVSGLV	prime_neg
TTCSIIWSQY	prime_neg
TTDALPESF	prime_neg
TTDLSLYNK	prime_neg
TTIESPSRK	cedar_neg
TTLARSASAR	prime_neg
TTLFHTFYEL	cedar_neg
TTLQTVSKDK	prime_neg
TTLVYPATEK	cedar_neg
TTMHTYKEL	prime_neg
TTNAFSGEY	prime_neg
TTNQRICFR	prime_neg
TTNQTVCFR	prime_neg
TTPESDLGMLR	prime_neg
TTSKHAETPY	prime_neg
TTSKHAETPYR	prime_neg
TTTATVSGL	prime_neg
TTTNQRICFR	prime_neg
TTTNQTVCFR	prime_neg
TTWQRPIMESV	cedar_neg
TTYSPIGEK	cedar_neg
TVASGENMTL	prime_neg
TVFGVSAAIDY	prime_neg
TVFYCVGLSAR	prime_neg
TVFYSDVGADK	prime_neg
TVGSRRQPEPK	prime_neg
TVIEYWSQK	cedar_neg
TVITEEFEV	cedar_neg
TVLDSMRLQK	prime_neg
TVLLSATIFL	prime_neg
TVLLSATIF	prime_neg
TVLVEHSEQK	prime_neg
TVMFDDAIER	prime_neg
TVMSAGSPVK	prime_neg
TVMSAGSPV	prime_neg
TVNMHRLHVK	cedar_neg
TVPSKFTFEV	cedar_neg
TVPSSSFSHR	prime_neg
TVQDLQVEV	prime_neg
TVQTGMDTSK	cedar_neg
TVSPFLSQR	cedar_neg
TVSRPNLKY	prime_neg
TVTECLNTFCK	cedar_neg
TWNEVFEFI	prime_neg
TWSTPHFYF	cedar_neg
TWVSEIVYII	prime_neg
TWVYEGTVL	prime_neg
TYGESFHII	cedar_neg
TYHGDSHLPL	prime_neg
TYLPSAWNF	cedar_pos
TYLPSAWNFF	cedar_pos
TYNETAGVLK	prime_neg
TYQVSYGFR	cedar_neg
TYSGKFLIL	cedar_neg
TYTKVMNWK	prime_neg
TYYPGKKEPF	cedar_neg
VAADLIMTLTF	cedar_neg
VAAGIICTL	prime_neg
VADINDHAL	cedar_pos
VAFCDMLLNV	cedar_neg
VAGAVGPHK	prime_neg
VAHFQLQMLK	cedar_neg
VAICCTLHY	prime_neg
VAKGFISRM	cedar_neg
VAKLANTVR	prime_neg
VAKNCGIAI	cedar_neg
VALLDGGLPA	prime_neg
VALPYFHSF	cedar_neg
VALSTCHEL	cedar_neg
VAMFDFIDCK	prime_neg
VAMGVALWGV	prime_neg
VAQADKYSTK	cedar_neg
VARGGSMGV	cedar_neg
VASGENMTLL	prime_neg
VASGENMTL	prime_neg
VATFYLYMK	prime_neg
VAVMKFKNPL	cedar_neg
VAWHSEVGLPL	cedar_neg
VCPIASSPCL	cedar_neg
VDNPLMCRL	cedar_pos
VEIEQLTY	prime_neg
VEISLISRLSF	prime_neg
VERASAIAW	cedar_pos
VETDAAQPAV	cedar_neg
VEVEYYTLFW	prime_neg
VEYPYTSF	prime_neg
VFFFFLLPV	prime_neg
VFKDILYEL	cedar_neg
VFKDLSVTL	cedar_neg
VFLDCLELY	cedar_neg
VFLGASMVYLI	cedar_neg
VFLRTLEKGDW	cedar_neg
VFSFTATLPF	prime_pos
VFSITKMESF	prime_neg
VFTQSFITVSI	cedar_pos
VFVGMNLTR	prime_neg
VFYRAWHQV	cedar_neg
VFYTILTPV	cedar_neg
VGADGVGKSAL	cedar_neg
VGFFFFFLPV	prime_pos
VGNLSSLTSEK	prime_neg
VHDETPHLTV	prime_neg
VIAMVHYLMIL	cedar_neg
VIDAAFNGGV	cedar_neg
VIEFLAPLK	prime_neg
VIFLACFAPY	cedar_neg
VIFSYTYII	prime_neg
VIHGVISSF	prime_neg
VIHGVISSFV	prime_neg
VIHSPKGKK	prime_neg
VIHSPKGKKR	prime_neg
VIIGITIDSV	prime_neg
VIIVGVGGAY	prime_neg
VIKFMLRNER	prime_neg
VIKKVAKSPK	cedar_neg
VILELLTPL	prime_neg
VILGNALPLV	prime_neg
VIMLNGTKK	cedar_neg
VINAEFMLLF	prime_neg
VINEVIHSPK	prime_neg
VINLLSCLPY	prime_neg
VIQASMFDQK	cedar_neg
VIQQKWRHYYR	prime_neg
VIRRDFSMADK	cedar_neg
VISISLNNAV	prime_neg
VISKKDFHK	cedar_neg
VISQLMKK	prime_neg
VISSFVHVEQY	prime_neg
VIVRTLSGK	cedar_neg
VIVVLFVTLQR	prime_neg
VIYVNSCLF	prime_neg
VKITDFGRAK	cedar_pos
VLAFFVHEL	prime_neg
VLAKKLKFV	cedar_neg
VLAMAIYKQ	cedar_pos
VLANDPDAHRL	cedar_neg
VLASGAFGT	prime_neg
VLASGAFGTV	prime_neg
VLASGAFGTVY	prime_neg
VLASRAYVA	prime_neg
VLAVKRTVF	cedar_neg
VLDDSETTI	cedar_pos
VLDEDFSAL	prime_neg
VLDGFIPGT	cedar_pos
VLDHKLEWV	cedar_neg
VLDKAGSFK	cedar_neg
VLDREFPFV	prime_neg
VLEFEQMNLY	cedar_neg
VLENFTIFLV	cedar_pos
VLESAPINTPL	cedar_neg
VLFEDAVAY	cedar_pos
VLFFCADLGL	prime_neg
VLFFRSASSI	cedar_neg
VLFHRAFLV	cedar_pos
VLFLFFFWGV	prime_neg
VLFQTHTNV	prime_neg
VLFTCVPAA	cedar_neg
VLFTCVPAAR	cedar_neg
VLFWLITFVL	prime_neg
VLFWLITFV	prime_neg
VLGIAFFSA	cedar_neg
VLGNRLVIWV	prime_neg
VLGTEDLYGY	prime_neg
VLGWIKVPV	prime_neg
VLHFKNSYHNL	cedar_neg
VLHPQTEGM	cedar_neg
VLICLRLLMRY	cedar_pos
VLIDAVVDGQV	cedar_neg
VLIDRTGEEIK	prime_neg
VLIESLEVL	cedar_neg
VLILILYLLSI	prime_neg
VLKAKPDFK	prime_neg
VLKEQIEEL	cedar_neg
VLLAIGFICA	prime_neg
VLLALVLLLL	prime_neg
VLLALVLLL	prime_neg
VLLFVAVWL	cedar_neg
VLLGVKLFGV	cedar_pos
VLLLLLAGV	prime_neg
VLLPKATSLPI	cedar_neg
VLLRALPVL	cedar_neg
VLLRFQPRV	cedar_neg
VLLSATIFL	prime_neg
VLLSATIFLV	prime_neg
VLLSICYLL	cedar_neg
VLLTSWNHSL	cedar_neg
VLLVILTLEV	prime_neg
VLLVLCQQPVI	prime_neg
VLLVLCQQPV	prime_neg
VLLVLWAFCV	prime_neg
VLLWEIFFL	prime_neg
VLLYAEIYA	cedar_neg
VLMAVAILK	cedar_neg
VLMAVAILKEV	cedar_neg
VLMGAVALGA	cedar_neg
VLMGAVALGAL	cedar_neg
VLMGYVAAV	prime_neg
VLNIVRFLK	cedar_neg
VLNPFIYML	cedar_pos
VLNYFKPYL	cedar_pos
VLPPCIISGGI	cedar_neg
VLQAGMLRI	cedar_neg
VLQEATICV	cedar_pos
VLQFARAHAL	prime_neg
VLSAQSHCSTY	cedar_neg
VLSDNVVMV	prime_neg
VLSNDVCAQV	cedar_pos
VLSQVDLPCGI	cedar_neg
VLSSLVLVPL	cedar_neg
VLSVATFVA	cedar_neg
VLSWLLKYKI	cedar_neg
VLTADGTSL	cedar_neg
VLTAEENLSI	cedar_neg
VLTPNLQGFY	prime_neg
VLVPIYIIYK	prime_neg
VLVSRMPFV	cedar_neg
VLVTFEDVAV	cedar_neg
VLVTGCMFV	cedar_neg
VLWAFCVGL	prime_neg
VLWDYVYQL	cedar_pos
VLWDYVYQLL	cedar_pos
VLWHVTYWV	cedar_neg
VLWVNTDQV	cedar_neg
VLYCVLIESL	cedar_neg
VLYGVTLSL	prime_neg
VLYLHITWV	cedar_neg
VLYSAQDQA	cedar_neg
VLYVVRSLY	prime_neg
VLYVWSFFL	cedar_neg
VMALTASTVPL	cedar_neg
VMASVDNPL	cedar_neg
VMDISYLNL	cedar_neg
VMDSIDVKI	cedar_neg
VMFDDAIERA	prime_neg
VMFDDAIER	prime_neg
VMGIRVAKY	prime_neg
VMGRSYAPY	prime_neg
VMIACNIREL	prime_pos
VMIIVSSLAV	cedar_pos
VMKFKNPLV	cedar_neg
VMLCGHDAV	cedar_neg
VMLEEILKTL	cedar_neg
VMLEGEQEA	cedar_pos
VMLENFRNLLL	cedar_neg
VMLKYLFSL	prime_neg
VMLQAPLFTA	prime_neg
VMLQAPLFT	prime_neg
VMLQIINIV	cedar_neg
VMLQIINIVL	cedar_neg
VMNNLLPTSV	cedar_neg
VMQNLSQTSV	prime_neg
VMSAGSPVK	prime_neg
VMSSLCTIA	cedar_neg
VMSWAPPVGL	prime_neg
VMYNWKMVI	cedar_neg
VNADSVVYY	prime_neg
VPAWGLVATL	prime_neg
VPAWGLVAT	prime_neg
VPCVCAVRY	prime_neg
VPDQKSKQL	cedar_neg
VPDQPQPPL	prime_neg
VPERAESSAM	prime_neg
VPERAESSA	prime_neg
VPFFTFLALY	prime_neg
VPGASSATAVL	cedar_neg
VPGQTGLKGL	prime_neg
VPIYEDNAL	prime_neg
VPKAYTWGAV	cedar_neg
VPKEHPAPPA	cedar_neg
VPKPSLSFYVL	prime_neg
VPRFVFKLY	cedar_neg
VPRFVFKLYY	cedar_neg
VPRFVFKLYYF	cedar_neg
VPSAWTDTQRL	cedar_neg
VPSRSDGDSSF	cedar_neg
VPTEDYMIH	prime_neg
VPVCSGASSM	prime_neg
VQALQKGRSF	prime_neg
VQDKCVEML	cedar_neg
VQFLSQVLWSR	prime_pos
VQFSQLQELK	prime_neg
VQFSQLQEL	prime_neg
VQIAWHIYR	prime_neg
VQKIFHINPR	prime_neg
VQKVASKIPF	cedar_neg
VQLEEEYEV	cedar_pos
VQLIMQLMPF	cedar_neg
VQPHYITVSV	cedar_neg
VQQIVQLSPV	prime_neg
VQQTTLQTVSK	prime_neg
VQSAGPGRPL	prime_neg
VQVGGVTYI	cedar_neg
VQVRTLVYTV	cedar_neg
VQYLGMFPV	cedar_pos
VRAKAPRISI	prime_neg
VRDLKKLEFV	prime_neg
VRLLWGSLL	prime_neg
VRLLWGSLLV	prime_neg
VRLPTGGPLL	prime_neg
VRQLQDSSTL	prime_neg
VRRASVCLITL	cedar_pos
VRRGPRLYDL	prime_neg
VRSGPGRPEL	prime_neg
VRTLLSQVNK	cedar_pos
VRYHYNATLL	prime_neg
VRYHYNATL	prime_neg
VSDGFTAVM	prime_neg
VSDMSLSLSS	prime_neg
VSEIVYIIYK	prime_neg
VSFHVIQIL	prime_neg
VSFPTPRVTL	prime_neg
VSGLTEDAAYK	prime_neg
VSILFLIISY	prime_neg
VSIPIGWSHF	prime_neg
VSITFRIPVSR	prime_neg
VSKIIGGNPK	cedar_neg
VSKILPSTW	cedar_pos
VSKLSPPGTAF	prime_neg
VSKPGLDYEL	cedar_neg
VSLVVKMFEL	prime_neg
VSQPVAPSY	cedar_neg
VSRKNDKYLLK	prime_neg
VSSSIYLHK	prime_neg
VSSSIYLHKPR	prime_neg
VSTKESPAKK	prime_neg
VSTKESPAK	prime_neg
VSVGDFSQEF	cedar_neg
VTATGSGIK	prime_neg
VTAYQNQQFTK	prime_neg
VTECLNTFCK	cedar_neg
VTEKLQPTY	cedar_pos
VTFAVSFYVV	cedar_neg
VTFELTWET	prime_neg
VTFGSLPPA	cedar_neg
VTFPDWADMY	prime_neg
VTFSCHGADK	cedar_neg
VTHYVRPQVRK	cedar_neg
VTIGPRLLL	cedar_pos
VTKGEHMTEK	cedar_neg
VTLDVILER	cedar_neg
VTLGIFFFFY	prime_neg
VTLNITSQGQK	prime_neg
VTMSWKERV	prime_neg
VTPGEREDAV	prime_neg
VTPLVLRSHKK	prime_neg
VTPLVLRSHK	prime_neg
VTRRHASHQTF	cedar_neg
VTRRLPGSR	prime_neg
VTYSGKFLI	cedar_neg
VTYYCHWGY	prime_neg
VVFFFFLLPV	prime_neg
VVGACGVGK	cedar_neg
VVGFFFFFL	prime_neg
VVHKRIHLGEK	cedar_neg
VVLAVRLSCK	prime_neg
VVLPPETRPI	prime_neg
VVLSVPAKV	cedar_neg
VVMRHLPFMR	prime_neg
VVMSWAPPV	cedar_pos
VVNMNEIVRTK	cedar_neg
VVNPIIYFY	prime_neg
VVNSWFWSRK	prime_neg
VVNSWFWSR	prime_neg
VVQSVTSVAK	cedar_neg
VVRETLQRNTF	cedar_neg
VVRHCPHHER	prime_neg
VVSHPHLVYW	cedar_neg
VVTAVLILV	cedar_neg
VVTEVFLLA	cedar_neg
VVVFFFFLL	prime_neg
VVVGACGVGK	cedar_neg
VVVGADGVGK	cedar_pos
VVVGAVGVGK	cedar_pos
VVVPCEPPEV	cedar_pos
VVYDRCEKLR	prime_neg
VWILCDAHCL	cedar_neg
VYALIAGATL	cedar_pos
VYCFLAVFSPF	prime_neg
VYGELHVQI	prime_neg
VYHEIHIGYL	cedar_pos
VYLACERLLYL	cedar_neg
VYMPSVFTL	prime_neg
VYMPSVFTLV	prime_neg
VYNLGNREAEL	cedar_neg
VYPPRGFSP	cedar_neg
VYPPRGFSPY	cedar_neg
VYPPRGFSPYL	cedar_neg
VYQGTTSNI	prime_neg
VYQYTFPDF	cedar_pos
VYQYTFPDFL	cedar_pos
VYRPLHYPLL	cedar_pos
VYRPLHYPL	prime_pos
VYSCVALPYF	cedar_neg
VYVAKLHDI	cedar_neg
VYWDYAMSI	prime_neg
WADWGHRTY	prime_neg
WALTFPMTAL	prime_neg
WATSSSRVW	cedar_neg
WCFLGSQNM	prime_neg
WDTNSSTIVF	prime_neg
WDVRAETTCY	prime_neg
WEDSQLVSHL	cedar_neg
WFQGERIAY	cedar_neg
WGYEVEGTSTL	prime_neg
WHDAISRKTF	prime_neg
WHDAISRKT	prime_neg
WIKLRSLLHY	prime_neg
WILCDAHCL	cedar_neg
WIPSSSLAK	cedar_neg
WLCRRSRAASV	cedar_neg
WLEWWHVQPTL	cedar_neg
WLFEYHRCTL	prime_neg
WLFGMDLNKI	cedar_neg
WLFLGHMVV	prime_neg
WLFLISAIQL	prime_neg
WLFWGLTYI	cedar_neg
WLIDMKSLV	cedar_neg
WLIDMKSLVM	cedar_neg
WLIEGDLQV	cedar_neg
WLIEGDLQVL	cedar_neg
WLINIENSRSL	cedar_neg
WLIRETQPITK	cedar_pos
WLITFVLNA	prime_neg
WLLGCVMYTL	prime_neg
WLLGCVMYT	prime_neg
WLLLCIPGL	cedar_neg
WLLLGPMVV	prime_neg
WLLMLLIGFL	cedar_neg
WLMPLTIPLA	prime_neg
WLMPLTIPL	prime_neg
WLNGFSVAML	cedar_neg
WLRDHRMTGL	cedar_neg
WLRGFSVAML	cedar_neg
WLSDASERHPV	cedar_neg
WLSFFTVMAY	prime_neg
WLSQGQFLL	cedar_neg
WLSVLECVEL	cedar_neg
WLVDLLPST	cedar_neg
WLVGGIVAA	cedar_neg
WLVWLFLGHM	prime_neg
WLVWLLLGPM	prime_neg
WLWEPLRVV	cedar_pos
WLWFVTVKSL	prime_neg
WLYHHVEGFA	prime_neg
WMAEFLIAV	prime_neg
WMLAEKTVQV	cedar_neg
WMNILCAWFIF	prime_neg
WMNILCAWFI	prime_neg
WMNILCAWF	prime_neg
WMNLFVGFRF	cedar_neg
WMSDSGTRL	prime_neg
WPGIPSSESEF	prime_neg
WPHPSWSAVF	prime_neg
WPPPPATTPF	prime_neg
WPSLDSGPL	prime_neg
WPTRVCADV	cedar_neg
WPTRVCADVTI	cedar_neg
WQADIVAAL	cedar_neg
WQGEGDGQSF	prime_neg
WQLEFLQPL	cedar_neg
WQRPIMESV	cedar_neg
WQRSQHSYK	prime_neg
WRFQQLDTAI	cedar_neg
WRNILLLSL	cedar_pos
WRNILLLSLH	cedar_pos
WRNSFLLRY	cedar_neg
WSCLGHLGY	prime_neg
WSIEVICYI	cedar_neg
WSIEVICYILV	cedar_neg
WSSTASSGY	prime_neg
WSTASKDVNIF	prime_neg
WTGATITVTIK	cedar_pos
WTHDNIMSK	cedar_neg
WTNETHVTY	prime_neg
WTRDSCDFSY	cedar_neg
WTWWINFLFDA	prime_neg
WVAPDSHIF	cedar_neg
WVCYQYSGYR	prime_neg
WVKEKNIMVR	prime_neg
WVLALFDEV	cedar_pos
WVMGIRVAKY	prime_neg
WVMPVIPAL	cedar_pos
WVNCSSMTFL	prime_neg
WVNGQSLLV	cedar_neg
WVSEIVYIIY	prime_neg
WVSGGALLTL	prime_neg
WVVSHPHLV	cedar_neg
WVYECTVFL	cedar_neg
WVYEGTVLL	prime_neg
WVYSSHRHL	cedar_neg
WYLKVINLF	cedar_neg
WYLLMPAAL	prime_neg
WYLRINKRGKV	cedar_neg
WYTHNLIF	prime_neg
WYTHNLIFVF	cedar_neg
YALVRLGIQTF	cedar_neg
YAMGPLAVDNF	prime_neg
YARPRSASI	prime_neg
YASSYIILA	cedar_neg
YASSYIILAM	cedar_neg
YATALYRQGEL	cedar_neg
YAVKSLSKENY	prime_neg
YCLYFIPYMF	prime_neg
YCLYFIPYM	prime_neg
YDEAMSVSLKK	cedar_neg
YDVWSLGITM	prime_neg
YDYVSALHPV	cedar_neg
YEGQVISNGF	cedar_pos
YEHEDVKEA	cedar_pos
YFATEGLRAL	prime_neg
YFATEGLWTL	prime_neg
YFATLITELF	cedar_pos
YFAWIGFYTGW	prime_neg
YFFHETRQYKF	cedar_neg
YFFWGLWAL	cedar_pos
YFSPADGNPI	prime_neg
YFYNQEEYVR	prime_neg
YGGDAVVEL	prime_neg
YGKEYWALTF	prime_neg
YHGDPMPCL	cedar_neg
YHHQCFPRRL	prime_neg
YHIHCVNPPL	prime_neg
YIAKYIVPYM	cedar_neg
YIAQFKGAW	cedar_neg
YIAQFKGAWIL	cedar_neg
YIASFFIETEF	cedar_neg
YIFQLSSLNL	cedar_neg
YIHGRGWAL	cedar_pos
YIIFFVLVIF	cedar_neg
YILKYSVFL	cedar_pos
YIMLLTNWRF	prime_neg
YIMMKTHLL	cedar_neg
YIPSNDLRAF	cedar_neg
YIPSNDLRAFV	cedar_neg
YIPTDSECRY	prime_neg
YIPTVLDQV	cedar_neg
YIQTINPLDVL	prime_neg
YIQTINPLDV	prime_neg
YIRARIFLI	cedar_neg
YISGWNPTL	cedar_neg
YISKCWDYA	cedar_neg
YISTFNLDHAL	prime_neg
YISTFNLDHA	prime_neg
YIVAASRLFFV	cedar_neg
YIVENDLYI	prime_neg
YIVSNCMVV	prime_neg
YIWDDPWFF	prime_neg
YIWDDPWFFR	prime_neg
YIWELVDIFV	prime_neg
YIYVCFCLYI	prime_neg
YIYVCFCLY	prime_neg
YKLVVVGAV	cedar_pos
YKYEECKDVI	prime_neg
YLAAETEQEI	prime_neg
YLACERLLYL	cedar_neg
YLAFLFVWEPF	prime_neg
YLAINEILGQL	cedar_neg
YLAMISEGYL	cedar_neg
YLAPQESYGA	cedar_neg
YLASLSLGY	prime_neg
YLCAGAVYF	cedar_pos
YLCLQNNFI	cedar_neg
YLCNKDSFAL	prime_neg
YLDDRNTFRHI	cedar_neg
YLDELIRNT	cedar_pos
YLDLKGPKV	cedar_pos
YLDNRFFTL	prime_neg
YLDTDVILM	cedar_pos
YLDYIKHPM	prime_neg
YLDYQIQATV	cedar_neg
YLDYQIQATVM	cedar_neg
YLEIEEHNFA	prime_neg
YLEKIILLVV	prime_neg
YLEPGPVTV	cedar_pos
YLESLGAAKPF	prime_neg
YLFFIQGYK	cedar_neg
YLFRGRINPEV	cedar_neg
YLFSLNEIVV	prime_neg
YLGSSTAFDFL	cedar_neg
YLHKHYNNL	cedar_neg
YLHSPMYFFI	prime_neg
YLHSWIKIDV	prime_neg
YLIGVIGNS	prime_neg
YLIIALGIHL	cedar_neg
YLIIDSNSTI	cedar_neg
YLILQVPPKI	prime_neg
YLIPCYFHA	cedar_neg
YLLAIFSGL	cedar_pos
YLLDAQIREI	cedar_neg
YLLDFTFVC	prime_neg
YLLEVNLQNGI	cedar_neg
YLLFMIGYT	cedar_pos
YLLFQNTDL	cedar_neg
YLLHKNCML	prime_neg
YLLLSARFYA	prime_neg
YLLLWLSPI	prime_neg
YLLNIPGPIYI	cedar_neg
YLLQKTMPVA	prime_neg
YLLQKTMPV	prime_neg
YLLSILGNT	prime_neg
YLLSILGNTTI	prime_neg
YLLSILGNTT	prime_neg
YLLTDCNPA	cedar_pos
YLMILSANWAY	cedar_neg
YLMILSANW	cedar_neg
YLMKGPNKI	prime_neg
YLMKNVTIYL	prime_neg
YLNCIINMK	prime_neg
YLNELVVFV	cedar_pos
YLNFEAAPYL	prime_neg
YLNIKEDYNAM	prime_neg
YLNKAGIVKA	prime_neg
YLNLALAVF	prime_neg
YLNWIVRNL	cedar_neg
YLPGEPEGI	cedar_neg
YLQAHQRVHTV	cedar_neg
YLQDSMATT	cedar_pos
YLQEKTCMAGV	prime_neg
YLQEKTCMA	prime_neg
YLQESAFSH	prime_neg
YLQTDVFLV	cedar_pos
YLRKRQVLIFL	cedar_neg
YLRSVPAGV	prime_neg
YLRTAKFLEM	cedar_neg
YLSDEISITT	prime_neg
YLSELLQTV	cedar_pos
YLSNIIPAL	cedar_pos
YLSNTTVTSL	cedar_neg
YLSPFMIVI	prime_neg
YLTDKDFEFA	cedar_pos
YLTDKDFEF	cedar_pos
YLTPQSNHLSV	cedar_neg
YLTSLACVEI	prime_neg
YLVDSVAKM	cedar_neg
YLVKNTFTK	cedar_neg
YLVLFFYLL	prime_neg
YLVSFFEGI	prime_neg
YLVYQMLKV	cedar_pos
YLWKAENTL	cedar_neg
YLWPPVQLA	cedar_pos
YLWRSSTSGL	prime_neg
YLWWVNGQSLL	cedar_neg
YLWYQVALSM	prime_neg
YLYDRLLRV	cedar_pos
YLYHRVDVI	cedar_pos
YLYHRVDVIFC	cedar_pos
YLYHRVDVIF	cedar_pos
YLYIEYNAI	prime_neg
YMAEGIFHS	cedar_neg
YMAELFPFI	prime_neg
YMAPEVVEVFA	cedar_neg
YMASEVVEV	cedar_neg
YMASEVVEVF	cedar_neg
YMDGTMSQV	cedar_pos
YMEAVALV	prime_neg
YMEKQQELL	prime_neg
YMFLASPSV	cedar_pos
YMFSDCSTSL	prime_neg
YMHLKVGSQAI	prime_neg
YMHTDLQAL	cedar_neg
YMHTDLQALHM	cedar_neg
YMIHIIEKW	prime_neg
YMKSLEFENK	cedar_pos
YMLFARGLL	prime_neg
YMLPFLEEI	prime_neg
YMLTLHTKL	cedar_pos
YMMMWDCWHA	cedar_pos
YMMMWDCWHAV	cedar_pos
YMMNSVQENF	cedar_pos
YMPCSAYQKV	cedar_neg
YMPGGDLVKL	cedar_neg
YMPTTIIAA	cedar_pos
YMQRCPEDFRL	cedar_neg
YMRAMSTISQL	prime_neg
YMSHRELSAWV	cedar_neg
YMTAVLEYL	cedar_neg
YMTGFFGGY	prime_neg
YMVLVPCLL	prime_neg
YMYEAPPGA	cedar_neg
YMYLRQLFHI	cedar_pos
YNFEMLQQHAV	cedar_neg
YNSFSSAPM	cedar_neg
YNTDDIEFY	cedar_neg
YPAKTQPLQH	prime_neg
YPAPQPPVL	cedar_neg
YPDTRSHASDV	prime_neg
YPFNAKQPTDV	cedar_neg
YPFQFVPGL	cedar_neg
YPGKDGKVM	prime_neg
YPHSLSSKL	cedar_neg
YPNGKFLAYAE	prime_neg
YPPPPPALL	cedar_pos
YPPRGFSPY	cedar_neg
YPPRGFSPYL	cedar_neg
YPPVPGNKL	prime_neg
YPSQAESDM	prime_neg
YPSYSQAQALL	prime_neg
YPVIFKSIM	cedar_pos
YQALQSRLQAL	prime_neg
YQDKWAEKPAF	cedar_neg
YQFFSDECSY	cedar_neg
YQFFSDECSYL	cedar_neg
YQGRTKLVKDF	cedar_neg
YQLALSIGTSY	cedar_neg
YQLSLSAVF	prime_neg
YQLYTLYPGK	prime_neg
YQNQQFTKLK	prime_neg
YQPATPRLGM	prime_neg
YQSLKQFNV	cedar_neg
YQVSCCDWLL	cedar_neg
YQVSYGFRL	cedar_pos
YQYMLDEQK	prime_neg
YQYSGYRGY	prime_neg
YQYTFPDFLY	cedar_pos
YRALTETVM	prime_neg
YRHLFKVFR	cedar_neg
YRIYDIPPK	cedar_neg
YRIYSKIMDLI	cedar_neg
YRPLHYPLL	prime_neg
YRVLQCANLL	prime_neg
YRVLQCANL	prime_neg
YSAEGVTLWY	prime_neg
YSASCYSSSCY	cedar_neg
YSAVMGRSY	prime_neg
YSCSQDHDTQK	prime_neg
YSDATDEDI	prime_neg
YSENDVATY	prime_neg
YSFQSLLYL	cedar_neg
YSFQSLLYLL	cedar_neg
YSFQSLLYLLL	cedar_neg
YSFSISSIL	cedar_neg
YSKNLNSFF	cedar_pos
YSLEEEAVSV	prime_neg
YSLYGGDAV	prime_neg
YSLYGGDAVV	prime_neg
YSMECFQFM	cedar_pos
YSNAQILHF	cedar_neg
YSNYYCGLRY	prime_pos
YSQLERNKLL	prime_neg
YSQLERNKL	prime_neg
YSSALDLCY	prime_neg
YSSEENLIF	prime_neg
YSSHRHLHVVY	cedar_neg
YSSIVANRW	cedar_neg
YSSLVALAFV	prime_neg
YSSPAILLKK	prime_neg
YSVSDAVATF	prime_neg
YSWSAQRQAL	cedar_neg
YSYWSIILGY	cedar_neg
YTAPGIVEI	cedar_neg
YTAPYPHPA	prime_neg
YTAQIILAL	cedar_neg
YTASTSDAV	cedar_neg
YTAVHYAASY	cedar_neg
YTAVSRPGR	prime_neg
YTCEENSVPY	prime_neg
YTCEKPYYY	cedar_neg
YTDFHCQYVK	prime_pos
YTDFHCQYV	prime_pos
YTEYAVKSLSK	prime_neg
YTFAYRTKL	prime_neg
YTFEIQGVNGV	cedar_neg
YTFEIQGV	prime_neg
YTFLIFSDY	prime_neg
YTFLISSDY	prime_neg
YTFPSTSTKHL	cedar_neg
YTFRNHIVACV	prime_neg
YTGELDENK	prime_neg
YTHEAVTLWY	prime_neg
YTHEVITLWY	prime_neg
YTHNLIFVF	cedar_neg
YTHNLIFVFYM	cedar_neg
YTHNLIFV	prime_neg
YTILRALEFHL	cedar_neg
YTILTPVLNPI	cedar_neg
YTLSQCFQL	cedar_neg
YTLYPGKDGK	prime_neg
YTMEEFMEL	prime_neg
YTPQTSGLAK	prime_neg
YTRDQIMTI	cedar_neg
YTRDQIMTIL	cedar_neg
YTSEHAASV	prime_neg
YTSEILSPI	cedar_neg
YTSLKIFYER	prime_neg
YTTNAFSGEY	prime_neg
YTTVRALTL	cedar_neg
YTVTMSWKERV	prime_neg
YTVTQLRPK	prime_neg
YTWPSGNIY	cedar_neg
YVAAYQRL	prime_neg
YVAGGQEVF	cedar_neg
YVAKYTVPV	cedar_neg
YVARGGSMGV	cedar_neg
YVDVTYNFII	prime_neg
YVDVTYNFI	prime_neg
YVEYYSWLSYL	cedar_neg
YVGSPLAAM	cedar_neg
YVIIAFPTSY	prime_neg
YVKLANLPY	prime_neg
YVLTWIVGA	cedar_pos
YVMASVFVCPL	cedar_neg
YVMCYEMSY	prime_neg
YVPCAHSPCV	prime_neg
YVPRFVFKL	cedar_neg
YVPRFVFKLYY	cedar_neg
YVRRVFITDDL	cedar_neg
YVRVTVQARVM	cedar_pos
YVSEELKVAAL	prime_neg
YVSEKDVISAK	cedar_neg
YVSYKMLLR	prime_neg
YVTAMDIFV	cedar_pos
YVTFAVSFYVV	cedar_neg
YVTSSFDWTV	prime_neg
YVVKQSQLK	prime_neg
YVVPGSPCL	cedar_pos
YVVPWPGKAAF	prime_neg
YVYDFGVSVS	cedar_pos
YVYSVAKTDSF	cedar_neg
YWIKPEDPF	prime_neg
YWSLLSHPL	cedar_neg
YYADAFDFY	cedar_neg
YYCEVLPGEI	prime_neg
YYCHWGYEV	prime_neg
YYEDIKNDF	prime_neg
YYLEGWRFL	cedar_neg
YYNCAFTRNII	prime_neg
YYNCAFTRNI	prime_neg
YYNFEGDIALL	cedar_neg
YYPGKKEPF	cedar_neg
YYSKNLNSF	cedar_pos
YYSKNLNSFF	cedar_pos
YYSPQAQTL	cedar_neg
